AAAACCCGCGTCCGGCCCG->AAACCCGCGTCCGGCCCGA
AAAACCCGCGTCCGGCGTT->AAACCCGCGTCCGGCGTTG
AAAACCCGCGTCCGGCTAG->AAACCCGCGTCCGGCTAGT
AAAACCCGCGTCCGGCTCT->AAACCCGCGTCCGGCTCTA
AAAACGGTCTCGCGGGATT->AAACGGTCTCGCGGGATTT
AAAAGCCTCGGCTAACTAG->AAAGCCTCGGCTAACTAGC
AAAAGCTCTACTGGTAATT->AAAGCTCTACTGGTAATTA
AAAAGGCCCCACGAAGACC->AAAGGCCCCACGAAGACCA
AAAAGTCTAACAGACTAAG->AAAGTCTAACAGACTAAGT
AAAATCCCCTAGGCCGCCC->AAATCCCCTAGGCCGCCCT
AAAATTATTCACAAAACCC->AAATTATTCACAAAACCCG
AAACACTTCGGAACGGTGT->AACACTTCGGAACGGTGTG
AAACAGGATCACCACTTTC->AACAGGATCACCACTTTCC
AAACCAGAGATCACTCGGG->AACCAGAGATCACTCGGGC
AAACCCATTACGAACGTAC->AACCCATTACGAACGTACG
AAACCCCATTTAACGGCTG->AACCCCATTTAACGGCTGT
AAACCCGCGTCCGGCCCGA->AACCCGCGTCCGGCCCGAT
AAACCCGCGTCCGGCGTTG->AACCCGCGTCCGGCGTTGT
AAACCCGCGTCCGGCTAGT->AACCCGCGTCCGGCTAGTT
AAACCCGCGTCCGGCTCTA->AACCCGCGTCCGGCTCTAT
AAACGGTCTCGCGGGATTT->AACGGTCTCGCGGGATTTC
AAACTCCGTCATGCATAAA->AACTCCGTCATGCATAAAT
AAACTGCTAAATGCAGGAC->AACTGCTAAATGCAGGACC
AAACTTCTGTATGTTCCGC->AACTTCTGTATGTTCCGCG
AAAGATCTACGCAGTCTAC->AAGATCTACGCAGTCTACT
AAAGCCTCGGCTAACTAGC->AAGCCTCGGCTAACTAGCT
AAAGCTCTACTGGTAATTA->AAGCTCTACTGGTAATTAG
AAAGCTGAGCGATCTGTAA->AAGCTGAGCGATCTGTAAT
AAAGGCCCCACGAAGACCA->AAGGCCCCACGAAGACCAG
AAAGGGAGAGGCTCGGACC->AAGGGAGAGGCTCGGACCA
AAAGGTGTTCCAAATTCCA->AAGGTGTTCCAAATTCCAT
AAAGTCCGAATAGGGCGCA->AAGTCCGAATAGGGCGCAC
AAAGTCTAACAGACTAAGT->AAGTCTAACAGACTAAGTT
AAAGTGACGCCCCAGACGT->AAGTGACGCCCCAGACGTA
AAAGTTTTTTAGGTTCCTG->AAGTTTTTTAGGTTCCTGG
AAATATTCCTCCAACGAAC->AATATTCCTCCAACGAACC
AAATCAAATGGACTATAAG->AATCAAATGGACTATAAGA
AAATCCCCTAGGCCGCCCT->AATCCCCTAGGCCGCCCTG
AAATCTTGTCGCTAGACTG->AATCTTGTCGCTAGACTGG
AAATGCAGGACCATGCAAA->AATGCAGGACCATGCAAAT
AAATGGACTATAAGAATAT->AATGGACTATAAGAATATT
AAATGGCTGATTACGAAAC->AATGGCTGATTACGAAACC
AAATTATTCACAAAACCCG->AATTATTCACAAAACCCGC
AAATTCCATGGGATGTGTA->AATTCCATGGGATGTGTAG
AAATTCGCCGACCTAGTAC->AATTCGCCGACCTAGTACG
AAATTCTAGGAGCTCCCTG->AATTCTAGGAGCTCCCTGT
AAATTTGCCCGCTCGCTAG->AATTTGCCCGCTCGCTAGG
AACAATGACGAGCACCTAC->ACAATGACGAGCACCTACT
AACAATGTGCCCTCCCCAC->ACAATGTGCCCTCCCCACC
AACACACAAAACCCGCGTC->ACACACAAAACCCGCGTCC
AACACTTCGGAACGGTGTG->ACACTTCGGAACGGTGTGG
AACAGACTAAGTTGGATTG->ACAGACTAAGTTGGATTGG
AACAGATATTGACCGGACG->ACAGATATTGACCGGACGA
AACAGGAAATTCTAGGAGC->ACAGGAAATTCTAGGAGCT
AACAGGAAGGGGACGCATG->ACAGGAAGGGGACGCATGA
AACAGGATCACCACTTTCC->ACAGGATCACCACTTTCCA
AACCAAACTCCGTCATGCA->ACCAAACTCCGTCATGCAT
AACCAACCATCTTACTACC->ACCAACCATCTTACTACCT
AACCAGAGATCACTCGGGC->ACCAGAGATCACTCGGGCC
AACCATCTTACTACCTTTT->ACCATCTTACTACCTTTTC
AACCCATTACGAACGTACG->ACCCATTACGAACGTACGA
AACCCCATTTAACGGCTGT->ACCCCATTTAACGGCTGTC
AACCCGCGTCCGGCCCGAT->ACCCGCGTCCGGCCCGATT
AACCCGCGTCCGGCGTTGT->ACCCGCGTCCGGCGTTGTC
AACCCGCGTCCGGCTAGTT->ACCCGCGTCCGGCTAGTTC
AACCCGCGTCCGGCTCTAT->ACCCGCGTCCGGCTCTATC
AACCTATGTTACTTAATCC->ACCTATGTTACTTAATCCG
AACCTCTGATCGGACACTC->ACCTCTGATCGGACACTCG
AACCTGTGGAGAGAGTATA->ACCTGTGGAGAGAGTATAC
AACGAACCTGTGGAGAGAG->ACGAACCTGTGGAGAGAGT
AACGAGAAAGTGACGCCCC->ACGAGAAAGTGACGCCCCA
AACGATCACAAAACCCGCG->ACGATCACAAAACCCGCGT
AACGCACTCTGGGAAATAT->ACGCACTCTGGGAAATATT
AACGCGCGAACAATGACGA->ACGCGCGAACAATGACGAG
AACGCTATGACTGGAGGAG->ACGCTATGACTGGAGGAGA
AACGCTCATTTTATCTAAA->ACGCTCATTTTATCTAAAA
AACGGCTGTCTCGCCTAGC->ACGGCTGTCTCGCCTAGCG
AACGGTCTCGCGGGATTTC->ACGGTCTCGCGGGATTTCG
AACGGTGTGGGACGTTTTG->ACGGTGTGGGACGTTTTGT
AACGTACGACCGCAGCAGA->ACGTACGACCGCAGCAGAA
AACTAAAACGGTCTCGCGG->ACTAAAACGGTCTCGCGGG
AACTAGCTCCCCGCCCCTT->ACTAGCTCCCCGCCCCTTC
AACTATAGCTTCTAAAAGT->ACTATAGCTTCTAAAAGTC
AACTCCGTCATGCATAAAT->ACTCCGTCATGCATAAATC
AACTCCTGCTAAGATGACG->ACTCCTGCTAAGATGACGC
AACTGCCGAGTTATATGTC->ACTGCCGAGTTATATGTCC
AACTGCTAAATGCAGGACC->ACTGCTAAATGCAGGACCA
AACTGTGGATGACTTCATC->ACTGTGGATGACTTCATCT
AACTTCTGTATGTTCCGCG->ACTTCTGTATGTTCCGCGC
AAGAAGGAGGCAAACTTCT->AGAAGGAGGCAAACTTCTG
AAGAATATTCCTGAGTGTG->AGAATATTCCTGAGTGTGG
AAGACAACCTATGTTACTT->AGACAACCTATGTTACTTA
AAGACCAGGATACGCCTAC->AGACCAGGATACGCCTACG
AAGATCCAAACACTTCGGA->AGATCCAAACACTTCGGAA
AAGATCTACGCAGTCTACT->AGATCTACGCAGTCTACTA
AAGATGACGCCTAGAACTG->AGATGACGCCTAGAACTGC
AAGCCTCGGCTAACTAGCT->AGCCTCGGCTAACTAGCTC
AAGCGGTCGTAAAGGGAGA->AGCGGTCGTAAAGGGAGAG
AAGCTCACTTTAAGTCAGA->AGCTCACTTTAAGTCAGAT
AAGCTCCCTGTCCCTAGGC->AGCTCCCTGTCCCTAGGCA
AAGCTCTACTGGTAATTAG->AGCTCTACTGGTAATTAGA
AAGCTGAGCGATCTGTAAT->AGCTGAGCGATCTGTAATA
AAGCTTGTGTTAGCACGCT->AGCTTGTGTTAGCACGCTT
AAGGAGGCAAACTTCTGTA->AGGAGGCAAACTTCTGTAT
AAGGCCCCACGAAGACCAG->AGGCCCCACGAAGACCAGG
AAGGCGGTTTGAAGATCCA->AGGCGGTTTGAAGATCCAA
AAGGGAGAGGCTCGGACCA->AGGGAGAGGCTCGGACCAC
AAGGGGACGCATGACAATT->AGGGGACGCATGACAATTG
AAGGTGTTCCAAATTCCAT->AGGTGTTCCAAATTCCATG
AAGTATTCCAGTAATAGTG->AGTATTCCAGTAATAGTGC
AAGTCAGATGCCGGCTTCT->AGTCAGATGCCGGCTTCTT
AAGTCCGAATAGGGCGCAC->AGTCCGAATAGGGCGCACA
AAGTCTAACAGACTAAGTT->AGTCTAACAGACTAAGTTG
AAGTGACGCCCCAGACGTA->AGTGACGCCCCAGACGTAG
AAGTTATCTTCATCATGAT->AGTTATCTTCATCATGATC
AAGTTGGATTGGGGGGAAC->AGTTGGATTGGGGGGAACA
AAGTTTTTTAGGTTCCTGG->AGTTTTTTAGGTTCCTGGC
AATAAAAGCCTCGGCTAAC->ATAAAAGCCTCGGCTAACT
AATAGGGCGCACACGCAAG->ATAGGGCGCACACGCAAGT
AATAGTCGGTCGGCAAGTT->ATAGTCGGTCGGCAAGTTA
AATAGTGCGGAAACCCCAT->ATAGTGCGGAAACCCCATT
AATATTCCTCCAACGAACC->ATATTCCTCCAACGAACCT
AATATTCCTGAGTGTGGCA->ATATTCCTGAGTGTGGCAC
AATCAAATGGACTATAAGA->ATCAAATGGACTATAAGAA
AATCACCTAAGAAGGAGGC->ATCACCTAAGAAGGAGGCA
AATCCATGCTACCCGATTA->ATCCATGCTACCCGATTAA
AATCCCAGCTCCCTGTCCC->ATCCCAGCTCCCTGTCCCT
AATCCCCTAGGCCGCCCTG->ATCCCCTAGGCCGCCCTGG
AATCCGCCCAGTATAATCA->ATCCGCCCAGTATAATCAC
AATCCGCGACAGATGACGC->ATCCGCGACAGATGACGCT
AATCGTACAGCTACACCTT->ATCGTACAGCTACACCTTC
AATCTTGTCGCTAGACTGG->ATCTTGTCGCTAGACTGGA
AATGACGAGCACCTACTCT->ATGACGAGCACCTACTCTT
AATGATCAAGCTCACTTTA->ATGATCAAGCTCACTTTAA
AATGCAGGACCATGCAAAT->ATGCAGGACCATGCAAATG
AATGCATTGATGCAGTGCG->ATGCATTGATGCAGTGCGT
AATGGACTATAAGAATATT->ATGGACTATAAGAATATTC
AATGGCTGATTACGAAACC->ATGGCTGATTACGAAACCA
AATGTGCCCTCCCCACCTT->ATGTGCCCTCCCCACCTTG
AATTACACAGATATGCTGC->ATTACACAGATATGCTGCT
AATTAGATATACCTACGGT->ATTAGATATACCTACGGTA
AATTATTCACAAAACCCGC->ATTATTCACAAAACCCGCG
AATTCAGAACGCTCATTTT->ATTCAGAACGCTCATTTTA
AATTCCATGGGATGTGTAG->ATTCCATGGGATGTGTAGA
AATTCGCCGACCTAGTACG->ATTCGCCGACCTAGTACGG
AATTCTAGGAGCTCCCTGT->ATTCTAGGAGCTCCCTGTC
AATTGGAGTGCGCTTCTAT->ATTGGAGTGCGCTTCTATT
AATTTGCCCGCTCGCTAGG->ATTTGCCCGCTCGCTAGGC
AATTTTTACGTCGCATTGA->ATTTTTACGTCGCATTGAT
ACAAAACCCGCGTCCGGCC->CAAAACCCGCGTCCGGCCC
ACAAAACCCGCGTCCGGCG->CAAAACCCGCGTCCGGCGT
ACAAAACCCGCGTCCGGCT->CAAAACCCGCGTCCGGCTA,CAAAACCCGCGTCCGGCTC
ACAAATCTTGTCGCTAGAC->CAAATCTTGTCGCTAGACT
ACAACCTATGTTACTTAAT->CAACCTATGTTACTTAATC
ACAACTCCTGCTAAGATGA->CAACTCCTGCTAAGATGAC
ACAATGACGAGCACCTACT->CAATGACGAGCACCTACTC
ACAATGTGCCCTCCCCACC->CAATGTGCCCTCCCCACCT
ACAATTGGAGTGCGCTTCT->CAATTGGAGTGCGCTTCTA
ACACAAAACCCGCGTCCGG->CACAAAACCCGCGTCCGGC
ACACACAAAACCCGCGTCC->CACACAAAACCCGCGTCCG
ACACACCTGGAGGCTAGGC->CACACCTGGAGGCTAGGCC
ACACAGATATGCTGCTCTC->CACAGATATGCTGCTCTCG
ACACCGCAGCTAGATGATT->CACCGCAGCTAGATGATTA
ACACCTGGAGGCTAGGCCT->CACCTGGAGGCTAGGCCTG
ACACCTTCAGGTCACTGCG->CACCTTCAGGTCACTGCGC
ACACGCAAGTATTCCAGTA->CACGCAAGTATTCCAGTAA
ACACTCGGCGGGAACGCTA->CACTCGGCGGGAACGCTAT
ACACTTCGGAACGGTGTGG->CACTTCGGAACGGTGTGGG
ACAGAACGATCACAAAACC->CAGAACGATCACAAAACCC
ACAGACTAAGTTGGATTGG->CAGACTAAGTTGGATTGGG
ACAGATATGCTGCTCTCGC->CAGATATGCTGCTCTCGCC
ACAGATATTGACCGGACGA->CAGATATTGACCGGACGAC
ACAGATGACGCTGCTCGAG->CAGATGACGCTGCTCGAGA
ACAGCTACACCTTCAGGTC->CAGCTACACCTTCAGGTCA
ACAGGAAATTCTAGGAGCT->CAGGAAATTCTAGGAGCTC
ACAGGAAGGGGACGCATGA->CAGGAAGGGGACGCATGAC
ACAGGATCACCACTTTCCA->CAGGATCACCACTTTCCAT
ACAGTGACATGAATTACAC->CAGTGACATGAATTACACA
ACAGTTATGGCCTAAGGCG->CAGTTATGGCCTAAGGCGG
ACATGAATTACACAGATAT->CATGAATTACACAGATATG
ACATGCGTACCCACAAAAC->CATGCGTACCCACAAAACC
ACCAAACTCCGTCATGCAT->CCAAACTCCGTCATGCATA
ACCAACCATCTTACTACCT->CCAACCATCTTACTACCTT
ACCAATTTTTACGTCGCAT->CCAATTTTTACGTCGCATT
ACCACAGTGACATGAATTA->CCACAGTGACATGAATTAC
ACCACTTTCCATGAACTAA->CCACTTTCCATGAACTAAA
ACCAGAAATTCGCCGACCT->CCAGAAATTCGCCGACCTA
ACCAGAGATCACTCGGGCC->CCAGAGATCACTCGGGCCC
ACCAGGATACGCCTACGGA->CCAGGATACGCCTACGGAT
ACCATCTTACTACCTTTTC->CCATCTTACTACCTTTTCC
ACCATGCAAATGGCTGATT->CCATGCAAATGGCTGATTA
ACCCACAAAACCCGCGTCC->CCCACAAAACCCGCGTCCG
ACCCATTACGAACGTACGA->CCCATTACGAACGTACGAC
ACCCCATTTAACGGCTGTC->CCCCATTTAACGGCTGTCT
ACCCCTTCAAACCCATTAC->CCCCTTCAAACCCATTACG
ACCCGATTAACGCGCGAAC->CCCGATTAACGCGCGAACA
ACCCGCGTCCGGCCCGATT->CCCGCGTCCGGCCCGATTG
ACCCGCGTCCGGCGTTGTC->CCCGCGTCCGGCGTTGTCG
ACCCGCGTCCGGCTAGTTC->CCCGCGTCCGGCTAGTTCT
ACCCGCGTCCGGCTCTATC->CCCGCGTCCGGCTCTATCC
ACCCTTATAAGACAACCTA->CCCTTATAAGACAACCTAT
ACCGCAGCAGAACCTCTGA->CCGCAGCAGAACCTCTGAT
ACCGCAGCTAGATGATTAT->CCGCAGCTAGATGATTATC
ACCGCGCCTGCACCAGATC->CCGCGCCTGCACCAGATCG
ACCGGAAACTGCTAAATGC->CCGGAAACTGCTAAATGCA
ACCGGACGACGAGGTATAA->CCGGACGACGAGGTATAAA
ACCTAAGAAGGAGGCAAAC->CCTAAGAAGGAGGCAAACT
ACCTAAGCTCCCTGTCCCT->CCTAAGCTCCCTGTCCCTA
ACCTACGGTACTAGCTCCC->CCTACGGTACTAGCTCCCT
ACCTACTCTTTGTCTCTGG->CCTACTCTTTGTCTCTGGG
ACCTAGTACGGCTATTATT->CCTAGTACGGCTATTATTC
ACCTATGTTACTTAATCCG->CCTATGTTACTTAATCCGC
ACCTCTGATCGGACACTCG->CCTCTGATCGGACACTCGG
ACCTGGAGGCTAGGCCTGG->CCTGGAGGCTAGGCCTGGA
ACCTGTGGAGAGAGTATAC->CCTGTGGAGAGAGTATACT
ACCTTCAGGTCACTGCGCC->CCTTCAGGTCACTGCGCCA
ACCTTGCACGAAAGGTGTT->CCTTGCACGAAAGGTGTTC
ACCTTTTCCTTTTTAACTG->CCTTTTCCTTTTTAACTGT
ACGAAACCAGAGATCACTC->CGAAACCAGAGATCACTCG
ACGAAAGGTGTTCCAAATT->CGAAAGGTGTTCCAAATTC
ACGAACCTGTGGAGAGAGT->CGAACCTGTGGAGAGAGTA
ACGAACGTACGACCGCAGC->CGAACGTACGACCGCAGCA
ACGAAGACCAGGATACGCC->CGAAGACCAGGATACGCCT
ACGAATCCATGCTACCCGA->CGAATCCATGCTACCCGAT
ACGACCGCAGCAGAACCTC->CGACCGCAGCAGAACCTCT
ACGACGAGGTATAAAGTTT->CGACGAGGTATAAAGTTTT
ACGACGCAGGATCTTTACG->CGACGCAGGATCTTTACGG
ACGAGAAAGTGACGCCCCA->CGAGAAAGTGACGCCCCAG
ACGAGCACCTACTCTTTGT->CGAGCACCTACTCTTTGTC
ACGAGGTATAAAGTTTTTT->CGAGGTATAAAGTTTTTTA
ACGATCACAAAACCCGCGT->CGATCACAAAACCCGCGTC
ACGCAAGTATTCCAGTAAT->CGCAAGTATTCCAGTAATA
ACGCACTCTGGGAAATATT->CGCACTCTGGGAAATATTC
ACGCAGGATCTTTACGGAG->CGCAGGATCTTTACGGAGG
ACGCAGTCTACTAACAGAT->CGCAGTCTACTAACAGATA
ACGCATGACAATTGGAGTG->CGCATGACAATTGGAGTGC
ACGCATTTTTTGACGAATC->CGCATTTTTTGACGAATCC
ACGCCCCAGACGTAGGTTA->CGCCCCAGACGTAGGTTAG
ACGCCTACGGATCCACAAC->CGCCTACGGATCCACAACT
ACGCCTAGAACTGCCGAGT->CGCCTAGAACTGCCGAGTT
ACGCGAGGACGGGTTGGTG->CGCGAGGACGGGTTGGTGG
ACGCGCGAACAATGACGAG->CGCGCGAACAATGACGAGC
ACGCGGTACACACCTGGAG->CGCGGTACACACCTGGAGG
ACGCTATGACTGGAGGAGA->CGCTATGACTGGAGGAGAG
ACGCTCATTTTATCTAAAA->CGCTCATTTTATCTAAAAG
ACGCTGCTCGAGAGAATGC->CGCTGCTCGAGAGAATGCA
ACGCTTTGCGGGCTAGCCT->CGCTTTGCGGGCTAGCCTC
ACGGACGTTGGCATTAGGT->CGGACGTTGGCATTAGGTG
ACGGAGGGAACGCACTCTG->CGGAGGGAACGCACTCTGG
ACGGATCCACAACTCCTGC->CGGATCCACAACTCCTGCT
ACGGCTATTATTCTGAAAT->CGGCTATTATTCTGAAATT
ACGGCTGTCTCGCCTAGCG->CGGCTGTCTCGCCTAGCGG
ACGGGTTGGTGGCATCGCA->CGGGTTGGTGGCATCGCAC
ACGGTACTAGCTCCCTGTC->CGGTACTAGCTCCCTGTCC
ACGGTCTCGCGGGATTTCG->CGGTCTCGCGGGATTTCGC
ACGGTGTGGGACGTTTTGT->CGGTGTGGGACGTTTTGTG
ACGTACGACCGCAGCAGAA->CGTACGACCGCAGCAGAAC
ACGTAGGTTAGTGCTGACC->CGTAGGTTAGTGCTGACCG
ACGTCGCATTGATTCTGCA->CGTCGCATTGATTCTGCAT
ACGTTGGCATTAGGTGCTA->CGTTGGCATTAGGTGCTAA
ACGTTTTGTGAGGGGGCCC->CGTTTTGTGAGGGGGCCCT
ACTAAAACGGTCTCGCGGG->CTAAAACGGTCTCGCGGGA
ACTAACAGATATTGACCGG->CTAACAGATATTGACCGGA
ACTAAGTTGGATTGGGGGG->CTAAGTTGGATTGGGGGGA
ACTACCTTTTCCTTTTTAA->CTACCTTTTCCTTTTTAAC
ACTAGCTCCCCGCCCCTTC->CTAGCTCCCCGCCCCTTCA
ACTAGCTCCCTGTCCCTAG->CTAGCTCCCTGTCCCTAGG
ACTAGGCGCGTTAGGGGCG->CTAGGCGCGTTAGGGGCGT
ACTAGTTCGAATAAAAGCC->CTAGTTCGAATAAAAGCCT
ACTATAAGAATATTCCTGA->CTATAAGAATATTCCTGAG
ACTATAGCTTCTAAAAGTC->CTATAGCTTCTAAAAGTCT
ACTCAACACACAAAACCCG->CTCAACACACAAAACCCGC
ACTCCGTCATGCATAAATC->CTCCGTCATGCATAAATCA
ACTCCTGCTAAGATGACGC->CTCCTGCTAAGATGACGCC
ACTCGGCGGGAACGCTATG->CTCGGCGGGAACGCTATGA
ACTCGGGCCCTAAAAGGCC->CTCGGGCCCTAAAAGGCCC
ACTCGTGGGTGGTGGGCCG->CTCGTGGGTGGTGGGCCGA
ACTCTGGGAAATATTCCTC->CTCTGGGAAATATTCCTCC
ACTCTTTGTCTCTGGGAAT->CTCTTTGTCTCTGGGAATG
ACTGCCGAGTTATATGTCC->CTGCCGAGTTATATGTCCG
ACTGCGCCATAGCAACAAT->CTGCGCCATAGCAACAATG
ACTGCTAAATGCAGGACCA->CTGCTAAATGCAGGACCAT
ACTGGAGGAGAGCATTGTA->CTGGAGGAGAGCATTGTAC
ACTGGATTTGCACACCGCA->CTGGATTTGCACACCGCAG
ACTGGTAATTAGATATACC->CTGGTAATTAGATATACCT
ACTGGTGATCAACCAACCA->CTGGTGATCAACCAACCAT
ACTGTGGATGACTTCATCT->CTGTGGATGACTTCATCTT
ACTTAATCCGCCCAGTATA->CTTAATCCGCCCAGTATAA
ACTTCATCTTAGCCGAGCT->CTTCATCTTAGCCGAGCTA
ACTTCGGAACGGTGTGGGA->CTTCGGAACGGTGTGGGAC
ACTTCTGTATGTTCCGCGC->CTTCTGTATGTTCCGCGCC
ACTTTAAGTCAGATGCCGG->CTTTAAGTCAGATGCCGGC
ACTTTCCATGAACTAAAAC->CTTTCCATGAACTAAAACG
AGAAAGTCCGAATAGGGCG->GAAAGTCCGAATAGGGCGC
AGAAAGTGACGCCCCAGAC->GAAAGTGACGCCCCAGACG
AGAAATTCGCCGACCTAGT->GAAATTCGCCGACCTAGTA
AGAACAGGAAGGGGACGCA->GAACAGGAAGGGGACGCAT
AGAACCTCTGATCGGACAC->GAACCTCTGATCGGACACT
AGAACGATCACAAAACCCG->GAACGATCACAAAACCCGC
AGAACGCTCATTTTATCTA->GAACGCTCATTTTATCTAA
AGAACTGCCGAGTTATATG->GAACTGCCGAGTTATATGT
AGAAGGAGGCAAACTTCTG->GAAGGAGGCAAACTTCTGT
AGAATATTCCTGAGTGTGG->GAATATTCCTGAGTGTGGC
AGAATGCATTGATGCAGTG->GAATGCATTGATGCAGTGC
AGACAACCTATGTTACTTA->GACAACCTATGTTACTTAA
AGACCAGGATACGCCTACG->GACCAGGATACGCCTACGG
AGACGTAGGTTAGTGCTGA->GACGTAGGTTAGTGCTGAC
AGACTAAGTTGGATTGGGG->GACTAAGTTGGATTGGGGG
AGACTGGATTTGCACACCG->GACTGGATTTGCACACCGC
AGAGAATGCATTGATGCAG->GAGAATGCATTGATGCAGT
AGAGAGTATACTGGTGATC->GAGAGTATACTGGTGATCA
AGAGATCACTCGGGCCCTA->GAGATCACTCGGGCCCTAA
AGAGCATTGTACAGTTATG->GAGCATTGTACAGTTATGG
AGAGGCTCGGACCACAGTG->GAGGCTCGGACCACAGTGA
AGAGTATACTGGTGATCAA->GAGTATACTGGTGATCAAC
AGATATACCTACGGTACTA->GATATACCTACGGTACTAG
AGATATGCTGCTCTCGCCT->GATATGCTGCTCTCGCCTG
AGATATTGACCGGACGACG->GATATTGACCGGACGACGA
AGATATTGTCAAAGCTGAG->GATATTGTCAAAGCTGAGC
AGATCACTCGGGCCCTAAA->GATCACTCGGGCCCTAAAA
AGATCCAAACACTTCGGAA->GATCCAAACACTTCGGAAC
AGATCTACGCAGTCTACTA->GATCTACGCAGTCTACTAA
AGATGACGCCTAGAACTGC->GATGACGCCTAGAACTGCC
AGATGACGCTGCTCGAGAG->GATGACGCTGCTCGAGAGA
AGATGATTATCCCACGCAT->GATGATTATCCCACGCATT
AGATGCCGGCTTCTTCGCG->GATGCCGGCTTCTTCGCGC
AGCAACAATGTGCCCTCCC->GCAACAATGTGCCCTCCCC
AGCACCTACTCTTTGTCTC->GCACCTACTCTTTGTCTCT
AGCACGCTTTGCGGGCTAG->GCACGCTTTGCGGGCTAGC
AGCAGAACCTCTGATCGGA->GCAGAACCTCTGATCGGAC
AGCAGGTGTACTAGTTCGA->GCAGGTGTACTAGTTCGAA
AGCATTGTACAGTTATGGC->GCATTGTACAGTTATGGCC
AGCCGAGCTATTAGTCTTC->GCCGAGCTATTAGTCTTCC
AGCCTCGCGTTCCTGCTTC->GCCTCGCGTTCCTGCTTCA
AGCCTCGGCTAACTAGCTC->GCCTCGGCTAACTAGCTCC
AGCCTGCATACCGGAAACT->GCCTGCATACCGGAAACTG
AGCCTTCAGCCTGCATACC->GCCTTCAGCCTGCATACCG
AGCGATCTGTAATAGTCGG->GCGATCTGTAATAGTCGGT
AGCGGCCGGCGGATAACCA->GCGGCCGGCGGATAACCAA
AGCGGGTGTGAAAGATCTA->GCGGGTGTGAAAGATCTAC
AGCGGTCGTAAAGGGAGAG->GCGGTCGTAAAGGGAGAGG
AGCTAAGCTTGTGTTAGCA->GCTAAGCTTGTGTTAGCAC
AGCTACACCTTCAGGTCAC->GCTACACCTTCAGGTCACT
AGCTAGATGATTATCCCAC->GCTAGATGATTATCCCACG
AGCTATTAGTCTTCCTTAT->GCTATTAGTCTTCCTTATC
AGCTCACTTTAAGTCAGAT->GCTCACTTTAAGTCAGATG
AGCTCCCCGCCCCTTCACT->GCTCCCCGCCCCTTCACTC
AGCTCCCTGTCCCTAGGCA->GCTCCCTGTCCCTAGGCAC
AGCTCCCTGTCCCTAGGCC->GCTCCCTGTCCCTAGGCCC
AGCTCCCTGTCCCTAGGCG->GCTCCCTGTCCCTAGGCGC
AGCTCCCTGTCCCTAGGCT->GCTCCCTGTCCCTAGGCTA
AGCTCTACTGGTAATTAGA->GCTCTACTGGTAATTAGAT
AGCTGAGCGATCTGTAATA->GCTGAGCGATCTGTAATAG
AGCTTCTAAAAGTCTAACA->GCTTCTAAAAGTCTAACAG
AGCTTGTGTTAGCACGCTT->GCTTGTGTTAGCACGCTTT
AGGAAATTCTAGGAGCTCC->GGAAATTCTAGGAGCTCCC
AGGAAGGGGACGCATGACA->GGAAGGGGACGCATGACAA
AGGACCATGCAAATGGCTG->GGACCATGCAAATGGCTGA
AGGACGGGTTGGTGGCATC->GGACGGGTTGGTGGCATCG
AGGAGAGCATTGTACAGTT->GGAGAGCATTGTACAGTTA
AGGAGCTCCCTGTCCCTAG->GGAGCTCCCTGTCCCTAGG
AGGAGGCAAACTTCTGTAT->GGAGGCAAACTTCTGTATG
AGGATACGCCTACGGATCC->GGATACGCCTACGGATCCA
AGGATCACCACTTTCCATG->GGATCACCACTTTCCATGA
AGGATCTTTACGGAGGGAA->GGATCTTTACGGAGGGAAC
AGGCAAACTTCTGTATGTT->GGCAAACTTCTGTATGTTC
AGGCACATGCGTACCCACA->GGCACATGCGTACCCACAA
AGGCAGCAGGTGTACTAGT->GGCAGCAGGTGTACTAGTT
AGGCCCCACGAAGACCAGG->GGCCCCACGAAGACCAGGA
AGGCCCGACTCAACACACA->GGCCCGACTCAACACACAA
AGGCCGCCCTGGTATCGTA->GGCCGCCCTGGTATCGTAA
AGGCCTGGAGCTAAGCTTG->GGCCTGGAGCTAAGCTTGT
AGGCGCAAAATTATTCACA->GGCGCAAAATTATTCACAA
AGGCGCGTTAGGGGCGTCG->GGCGCGTTAGGGGCGTCGT
AGGCGGTTTGAAGATCCAA->GGCGGTTTGAAGATCCAAA
AGGCTACAGAACGATCACA->GGCTACAGAACGATCACAA
AGGCTAGGCCTGGAGCTAA->GGCTAGGCCTGGAGCTAAG
AGGCTCGGACCACAGTGAC->GGCTCGGACCACAGTGACA
AGGGAACGCACTCTGGGAA->GGGAACGCACTCTGGGAAA
AGGGAGAGGCTCGGACCAC->GGGAGAGGCTCGGACCACA
AGGGCGCACACGCAAGTAT->GGGCGCACACGCAAGTATT
AGGGGACGCATGACAATTG->GGGGACGCATGACAATTGG
AGGGGCGTCGTCGCGTCGT->GGGGCGTCGTCGCGTCGTT
AGGGGGCCCTGGGGTTGCA->GGGGGCCCTGGGGTTGCAC
AGGTACCAATTTTTACGTC->GGTACCAATTTTTACGTCG
AGGTATAAAGTTTTTTAGG->GGTATAAAGTTTTTTAGGT
AGGTCACTGCGCCATAGCA->GGTCACTGCGCCATAGCAA
AGGTGCTAATCGTACAGCT->GGTGCTAATCGTACAGCTA
AGGTGTACTAGTTCGAATA->GGTGTACTAGTTCGAATAA
AGGTGTTCCAAATTCCATG->GGTGTTCCAAATTCCATGG
AGGTTAGTGCTGACCGCGC->GGTTAGTGCTGACCGCGCC
AGGTTCCTGGCTTAGTAAA->GGTTCCTGGCTTAGTAAAA
AGTAAAATCCCCTAGGCCG->GTAAAATCCCCTAGGCCGC
AGTAATAGTGCGGAAACCC->GTAATAGTGCGGAAACCCC
AGTACGGCTATTATTCTGA->GTACGGCTATTATTCTGAA
AGTATAATCACCTAAGAAG->GTATAATCACCTAAGAAGG
AGTATACTGGTGATCAACC->GTATACTGGTGATCAACCA
AGTATTCCAGTAATAGTGC->GTATTCCAGTAATAGTGCG
AGTCAGATGCCGGCTTCTT->GTCAGATGCCGGCTTCTTC
AGTCCGAATAGGGCGCACA->GTCCGAATAGGGCGCACAC
AGTCGGTCGGCAAGTTATC->GTCGGTCGGCAAGTTATCT
AGTCTAACAGACTAAGTTG->GTCTAACAGACTAAGTTGG
AGTCTACTAACAGATATTG->GTCTACTAACAGATATTGA
AGTCTTCCTTATCGCGGGT->GTCTTCCTTATCGCGGGTC
AGTGAATTCAGAACGCTCA->GTGAATTCAGAACGCTCAT
AGTGACATGAATTACACAG->GTGACATGAATTACACAGA
AGTGACGCCCCAGACGTAG->GTGACGCCCCAGACGTAGG
AGTGCGCTTCTATTACGGA->GTGCGCTTCTATTACGGAC
AGTGCGGAAACCCCATTTA->GTGCGGAAACCCCATTTAA
AGTGCGTCGTCTGGCCCAC->GTGCGTCGTCTGGCCCACG
AGTGCTGACCGCGCCTGCA->GTGCTGACCGCGCCTGCAC
AGTGTGGCACCCTTATAAG->GTGTGGCACCCTTATAAGA
AGTTATATGTCCGTGCAAA->GTTATATGTCCGTGCAAAC
AGTTATCTTCATCATGATC->GTTATCTTCATCATGATCT
AGTTATGGCCTAAGGCGGT->GTTATGGCCTAAGGCGGTT
AGTTCGAATAAAAGCCTCG->GTTCGAATAAAAGCCTCGG
AGTTCTATCCGATTCGGAT->GTTCTATCCGATTCGGATT
AGTTGGATTGGGGGGAACA->GTTGGATTGGGGGGAACAG
AGTTTTTTAGGTTCCTGGC->GTTTTTTAGGTTCCTGGCT
ATAAAAGCCTCGGCTAACT->TAAAAGCCTCGGCTAACTA
ATAAAGTTTTTTAGGTTCC->TAAAGTTTTTTAGGTTCCT
ATAAATCAAATGGACTATA->TAAATCAAATGGACTATAA
ATAACCAAACTCCGTCATG->TAACCAAACTCCGTCATGC
ATAACGAGAAAGTGACGCC->TAACGAGAAAGTGACGCCC
ATAAGAATATTCCTGAGTG->TAAGAATATTCCTGAGTGT
ATAAGACAACCTATGTTAC->TAAGACAACCTATGTTACT
ATAATCACCTAAGAAGGAG->TAATCACCTAAGAAGGAGG
ATACCGGAAACTGCTAAAT->TACCGGAAACTGCTAAATG
ATACCTACGGTACTAGCTC->TACCTACGGTACTAGCTCC
ATACGCCTACGGATCCACA->TACGCCTACGGATCCACAA
ATACTGGTGATCAACCAAC->TACTGGTGATCAACCAACC
ATAGCAACAATGTGCCCTC->TAGCAACAATGTGCCCTCC
ATAGCTTCTAAAAGTCTAA->TAGCTTCTAAAAGTCTAAC
ATAGGGCGCACACGCAAGT->TAGGGCGCACACGCAAGTA
ATAGTCGGTCGGCAAGTTA->TAGTCGGTCGGCAAGTTAT
ATAGTGCGGAAACCCCATT->TAGTGCGGAAACCCCATTT
ATATACCTACGGTACTAGC->TATACCTACGGTACTAGCT
ATATGCTGCTCTCGCCTGT->TATGCTGCTCTCGCCTGTG
ATATGTCCGTGCAAACAGG->TATGTCCGTGCAAACAGGA
ATATTCCTCCAACGAACCT->TATTCCTCCAACGAACCTG
ATATTCCTGAGTGTGGCAC->TATTCCTGAGTGTGGCACC
ATATTGACCGGACGACGAG->TATTGACCGGACGACGAGG
ATATTGTCAAAGCTGAGCG->TATTGTCAAAGCTGAGCGA
ATCAAATGGACTATAAGAA->TCAAATGGACTATAAGAAT
ATCAACCAACCATCTTACT->TCAACCAACCATCTTACTA
ATCAAGCTCACTTTAAGTC->TCAAGCTCACTTTAAGTCA
ATCACAAAACCCGCGTCCG->TCACAAAACCCGCGTCCGG
ATCACCACTTTCCATGAAC->TCACCACTTTCCATGAACT
ATCACCTAAGAAGGAGGCA->TCACCTAAGAAGGAGGCAA
ATCACTCGGGCCCTAAAAG->TCACTCGGGCCCTAAAAGG
ATCATGATCTTTGTCAGAA->TCATGATCTTTGTCAGAAA
ATCCAAACACTTCGGAACG->TCCAAACACTTCGGAACGG
ATCCACAACTCCTGCTAAG->TCCACAACTCCTGCTAAGA
ATCCAGCGGGTGTGAAAGA->TCCAGCGGGTGTGAAAGAT
ATCCATGCTACCCGATTAA->TCCATGCTACCCGATTAAC
ATCCCACGCATTTTTTGAC->TCCCACGCATTTTTTGACG
ATCCCAGCTCCCTGTCCCT->TCCCAGCTCCCTGTCCCTA
ATCCCCTAGGCCGCCCTGG->TCCCCTAGGCCGCCCTGGT
ATCCGATTCGGATTGGCGC->TCCGATTCGGATTGGCGCG
ATCCGCCCAGTATAATCAC->TCCGCCCAGTATAATCACC
ATCCGCGACAGATGACGCT->TCCGCGACAGATGACGCTG
ATCGCACGCGGTACACACC->TCGCACGCGGTACACACCT
ATCGCGGGTCACCAGAAAT->TCGCGGGTCACCAGAAATT
ATCGGACACTCGGCGGGAA->TCGGACACTCGGCGGGAAC
ATCGTAATCCGCGACAGAT->TCGTAATCCGCGACAGATG
ATCGTACAGCTACACCTTC->TCGTACAGCTACACCTTCA
ATCTAAAAGCTCTACTGGT->TCTAAAAGCTCTACTGGTA
ATCTACGCAGTCTACTAAC->TCTACGCAGTCTACTAACA
ATCTGAATCCCAGCTCCCT->TCTGAATCCCAGCTCCCTG
ATCTGTAATAGTCGGTCGG->TCTGTAATAGTCGGTCGGC
ATCTTACTACCTTTTCCTT->TCTTACTACCTTTTCCTTT
ATCTTAGCCGAGCTATTAG->TCTTAGCCGAGCTATTAGT
ATCTTCATCATGATCTTTG->TCTTCATCATGATCTTTGT
ATCTTGTCGCTAGACTGGA->TCTTGTCGCTAGACTGGAT
ATCTTTACGGAGGGAACGC->TCTTTACGGAGGGAACGCA
ATCTTTGTCAGAAAGTCCG->TCTTTGTCAGAAAGTCCGA
ATGAACTAAAACGGTCTCG->TGAACTAAAACGGTCTCGC
ATGAATTACACAGATATGC->TGAATTACACAGATATGCT
ATGACAATTGGAGTGCGCT->TGACAATTGGAGTGCGCTT
ATGACGAGCACCTACTCTT->TGACGAGCACCTACTCTTT
ATGACGCCTAGAACTGCCG->TGACGCCTAGAACTGCCGA
ATGACGCTGCTCGAGAGAA->TGACGCTGCTCGAGAGAAT
ATGACTGGAGGAGAGCATT->TGACTGGAGGAGAGCATTG
ATGACTTCATCTTAGCCGA->TGACTTCATCTTAGCCGAG
ATGATAACGAGAAAGTGAC->TGATAACGAGAAAGTGACG
ATGATCAAGCTCACTTTAA->TGATCAAGCTCACTTTAAG
ATGATCTTTGTCAGAAAGT->TGATCTTTGTCAGAAAGTC
ATGATTATCCCACGCATTT->TGATTATCCCACGCATTTT
ATGCAAATGGCTGATTACG->TGCAAATGGCTGATTACGA
ATGCAGGACCATGCAAATG->TGCAGGACCATGCAAATGG
ATGCAGTGCGTCGTCTGGC->TGCAGTGCGTCGTCTGGCC
ATGCATAAATCAAATGGAC->TGCATAAATCAAATGGACT
ATGCATTGATGCAGTGCGT->TGCATTGATGCAGTGCGTC
ATGCCGGCTTCTTCGCGCG->TGCCGGCTTCTTCGCGCGC
ATGCGTACCCACAAAACCC->TGCGTACCCACAAAACCCG
ATGCTACCCGATTAACGCG->TGCTACCCGATTAACGCGC
ATGCTGCTCTCGCCTGTGT->TGCTGCTCTCGCCTGTGTA
ATGGACCTAAGCTCCCTGT->TGGACCTAAGCTCCCTGTC
ATGGACTATAAGAATATTC->TGGACTATAAGAATATTCC
ATGGCCTAAGGCGGTTTGA->TGGCCTAAGGCGGTTTGAA
ATGGCTGATTACGAAACCA->TGGCTGATTACGAAACCAG
ATGGGATGTGTAGATATTG->TGGGATGTGTAGATATTGT
ATGGTCAGAACAGGAAGGG->TGGTCAGAACAGGAAGGGG
ATGTATGGTCAGAACAGGA->TGTATGGTCAGAACAGGAA
ATGTCCGTGCAAACAGGAT->TGTCCGTGCAAACAGGATC
ATGTGCCCTCCCCACCTTG->TGTGCCCTCCCCACCTTGC
ATGTGTAGATATTGTCAAA->TGTGTAGATATTGTCAAAG
ATGTTACTTAATCCGCCCA->TGTTACTTAATCCGCCCAG
ATGTTCCGCGCCACCCCTT->TGTTCCGCGCCACCCCTTC
ATTAACGCGCGAACAATGA->TTAACGCGCGAACAATGAC
ATTACACAGATATGCTGCT->TTACACAGATATGCTGCTC
ATTACGAAACCAGAGATCA->TTACGAAACCAGAGATCAC
ATTACGAACGTACGACCGC->TTACGAACGTACGACCGCA
ATTACGGACGTTGGCATTA->TTACGGACGTTGGCATTAG
ATTAGATATACCTACGGTA->TTAGATATACCTACGGTAC
ATTAGGTGCTAATCGTACA->TTAGGTGCTAATCGTACAG
ATTAGTCTTCCTTATCGCG->TTAGTCTTCCTTATCGCGG
ATTATCCCACGCATTTTTT->TTATCCCACGCATTTTTTG
ATTATTCACAAAACCCGCG->TTATTCACAAAACCCGCGT
ATTATTCTGAAATTTGCCC->TTATTCTGAAATTTGCCCG
ATTCACAAAACCCGCGTCC->TTCACAAAACCCGCGTCCG
ATTCAGAACGCTCATTTTA->TTCAGAACGCTCATTTTAT
ATTCCAGTAATAGTGCGGA->TTCCAGTAATAGTGCGGAA
ATTCCATGGGATGTGTAGA->TTCCATGGGATGTGTAGAT
ATTCCTCCAACGAACCTGT->TTCCTCCAACGAACCTGTG
ATTCCTGAGTGTGGCACCC->TTCCTGAGTGTGGCACCCT
ATTCGCCGACCTAGTACGG->TTCGCCGACCTAGTACGGC
ATTCGGATTGGCGCGGACT->TTCGGATTGGCGCGGACTA
ATTCTAGGAGCTCCCTGTC->TTCTAGGAGCTCCCTGTCC
ATTCTGAAATTTGCCCGCT->TTCTGAAATTTGCCCGCTC
ATTCTGCATTTATGATAAC->TTCTGCATTTATGATAACG
ATTGACCGGACGACGAGGT->TTGACCGGACGACGAGGTA
ATTGATGCAGTGCGTCGTC->TTGATGCAGTGCGTCGTCT
ATTGATGTATGGTCAGAAC->TTGATGTATGGTCAGAACA
ATTGATTCTGCATTTATGA->TTGATTCTGCATTTATGAT
ATTGGAGTGCGCTTCTATT->TTGGAGTGCGCTTCTATTA
ATTGGCGCGGACTAGGCGC->TTGGCGCGGACTAGGCGCG
ATTGGGGGGAACAGGAAAT->TTGGGGGGAACAGGAAATT
ATTGTACAGTTATGGCCTA->TTGTACAGTTATGGCCTAA
ATTGTCAAAGCTGAGCGAT->TTGTCAAAGCTGAGCGATC
ATTTAACGGCTGTCTCGCC->TTTAACGGCTGTCTCGCCT
ATTTATGATAACGAGAAAG->TTTATGATAACGAGAAAGT
ATTTCGCAGTGAATTCAGA->TTTCGCAGTGAATTCAGAA
ATTTGCACACCGCAGCTAG->TTTGCACACCGCAGCTAGA
ATTTGCCCGCTCGCTAGGC->TTTGCCCGCTCGCTAGGCA
ATTTTATCTAAAAGCTCTA->TTTTATCTAAAAGCTCTAC
ATTTTTACGTCGCATTGAT->TTTTTACGTCGCATTGATT
ATTTTTTGACGAATCCATG->TTTTTTGACGAATCCATGC
CAAAACCCGCGTCCGGCCC->AAAACCCGCGTCCGGCCCG
CAAAACCCGCGTCCGGCGT->AAAACCCGCGTCCGGCGTT
CAAAACCCGCGTCCGGCTA->AAAACCCGCGTCCGGCTAG
CAAAACCCGCGTCCGGCTC->AAAACCCGCGTCCGGCTCT
CAAAATTATTCACAAAACC->AAAATTATTCACAAAACCC
CAAACACTTCGGAACGGTG->AAACACTTCGGAACGGTGT
CAAACAGGATCACCACTTT->AAACAGGATCACCACTTTC
CAAACCCATTACGAACGTA->AAACCCATTACGAACGTAC
CAAACTCCGTCATGCATAA->AAACTCCGTCATGCATAAA
CAAACTTCTGTATGTTCCG->AAACTTCTGTATGTTCCGC
CAAAGCTGAGCGATCTGTA->AAAGCTGAGCGATCTGTAA
CAAATCTTGTCGCTAGACT->AAATCTTGTCGCTAGACTG
CAAATGGACTATAAGAATA->AAATGGACTATAAGAATAT
CAAATGGCTGATTACGAAA->AAATGGCTGATTACGAAAC
CAAATTCCATGGGATGTGT->AAATTCCATGGGATGTGTA
CAACAATGTGCCCTCCCCA->AACAATGTGCCCTCCCCAC
CAACACACAAAACCCGCGT->AACACACAAAACCCGCGTC
CAACCAACCATCTTACTAC->AACCAACCATCTTACTACC
CAACCATCTTACTACCTTT->AACCATCTTACTACCTTTT
CAACCTATGTTACTTAATC->AACCTATGTTACTTAATCC
CAACGAACCTGTGGAGAGA->AACGAACCTGTGGAGAGAG
CAACTCCTGCTAAGATGAC->AACTCCTGCTAAGATGACG
CAAGCTCACTTTAAGTCAG->AAGCTCACTTTAAGTCAGA
CAAGTATTCCAGTAATAGT->AAGTATTCCAGTAATAGTG
CAAGTTATCTTCATCATGA->AAGTTATCTTCATCATGAT
CAATGACGAGCACCTACTC->AATGACGAGCACCTACTCT
CAATGTGCCCTCCCCACCT->AATGTGCCCTCCCCACCTT
CAATTGGAGTGCGCTTCTA->AATTGGAGTGCGCTTCTAT
CAATTTTTACGTCGCATTG->AATTTTTACGTCGCATTGA
CACAAAACCCGCGTCCGGC->ACAAAACCCGCGTCCGGCC,ACAAAACCCGCGTCCGGCG,ACAAAACCCGCGTCCGGCT,ACAAAACCCGCGTCCGGCT
CACAAATCTTGTCGCTAGA->ACAAATCTTGTCGCTAGAC
CACAACTCCTGCTAAGATG->ACAACTCCTGCTAAGATGA
CACACAAAACCCGCGTCCG->ACACAAAACCCGCGTCCGG
CACACCGCAGCTAGATGAT->ACACCGCAGCTAGATGATT
CACACCTGGAGGCTAGGCC->ACACCTGGAGGCTAGGCCT
CACACGCAAGTATTCCAGT->ACACGCAAGTATTCCAGTA
CACAGATATGCTGCTCTCG->ACAGATATGCTGCTCTCGC
CACAGTGACATGAATTACA->ACAGTGACATGAATTACAC
CACATGCGTACCCACAAAA->ACATGCGTACCCACAAAAC
CACCACTTTCCATGAACTA->ACCACTTTCCATGAACTAA
CACCAGAAATTCGCCGACC->ACCAGAAATTCGCCGACCT
CACCCCTTCAAACCCATTA->ACCCCTTCAAACCCATTAC
CACCCTTATAAGACAACCT->ACCCTTATAAGACAACCTA
CACCGCAGCTAGATGATTA->ACCGCAGCTAGATGATTAT
CACCTAAGAAGGAGGCAAA->ACCTAAGAAGGAGGCAAAC
CACCTACTCTTTGTCTCTG->ACCTACTCTTTGTCTCTGG
CACCTGGAGGCTAGGCCTG->ACCTGGAGGCTAGGCCTGG
CACCTTCAGGTCACTGCGC->ACCTTCAGGTCACTGCGCC
CACCTTGCACGAAAGGTGT->ACCTTGCACGAAAGGTGTT
CACGAAAGGTGTTCCAAAT->ACGAAAGGTGTTCCAAATT
CACGAAGACCAGGATACGC->ACGAAGACCAGGATACGCC
CACGCAAGTATTCCAGTAA->ACGCAAGTATTCCAGTAAT
CACGCATTTTTTGACGAAT->ACGCATTTTTTGACGAATC
CACGCGAGGACGGGTTGGT->ACGCGAGGACGGGTTGGTG
CACGCGGTACACACCTGGA->ACGCGGTACACACCTGGAG
CACGCTTTGCGGGCTAGCC->ACGCTTTGCGGGCTAGCCT
CACTCGGCGGGAACGCTAT->ACTCGGCGGGAACGCTATG
CACTCGGGCCCTAAAAGGC->ACTCGGGCCCTAAAAGGCC
CACTCGTGGGTGGTGGGCC->ACTCGTGGGTGGTGGGCCG
CACTCTGGGAAATATTCCT->ACTCTGGGAAATATTCCTC
CACTGCGCCATAGCAACAA->ACTGCGCCATAGCAACAAT
CACTTCGGAACGGTGTGGG->ACTTCGGAACGGTGTGGGA
CACTTTAAGTCAGATGCCG->ACTTTAAGTCAGATGCCGG
CACTTTCCATGAACTAAAA->ACTTTCCATGAACTAAAAC
CAGAAAGTCCGAATAGGGC->AGAAAGTCCGAATAGGGCG
CAGAAATTCGCCGACCTAG->AGAAATTCGCCGACCTAGT
CAGAACAGGAAGGGGACGC->AGAACAGGAAGGGGACGCA
CAGAACCTCTGATCGGACA->AGAACCTCTGATCGGACAC
CAGAACGATCACAAAACCC->AGAACGATCACAAAACCCG
CAGAACGCTCATTTTATCT->AGAACGCTCATTTTATCTA
CAGACGTAGGTTAGTGCTG->AGACGTAGGTTAGTGCTGA
CAGACTAAGTTGGATTGGG->AGACTAAGTTGGATTGGGG
CAGAGATCACTCGGGCCCT->AGAGATCACTCGGGCCCTA
CAGATATGCTGCTCTCGCC->AGATATGCTGCTCTCGCCT
CAGATATTGACCGGACGAC->AGATATTGACCGGACGACG
CAGATGACGCTGCTCGAGA->AGATGACGCTGCTCGAGAG
CAGATGCCGGCTTCTTCGC->AGATGCCGGCTTCTTCGCG
CAGCAGAACCTCTGATCGG->AGCAGAACCTCTGATCGGA
CAGCAGGTGTACTAGTTCG->AGCAGGTGTACTAGTTCGA
CAGCCTGCATACCGGAAAC->AGCCTGCATACCGGAAACT
CAGCGGGTGTGAAAGATCT->AGCGGGTGTGAAAGATCTA
CAGCTACACCTTCAGGTCA->AGCTACACCTTCAGGTCAC
CAGCTAGATGATTATCCCA->AGCTAGATGATTATCCCAC
CAGCTCCCTGTCCCTAGGC->AGCTCCCTGTCCCTAGGCC
CAGGAAATTCTAGGAGCTC->AGGAAATTCTAGGAGCTCC
CAGGAAGGGGACGCATGAC->AGGAAGGGGACGCATGACA
CAGGACCATGCAAATGGCT->AGGACCATGCAAATGGCTG
CAGGATACGCCTACGGATC->AGGATACGCCTACGGATCC
CAGGATCACCACTTTCCAT->AGGATCACCACTTTCCATG
CAGGATCTTTACGGAGGGA->AGGATCTTTACGGAGGGAA
CAGGTACCAATTTTTACGT->AGGTACCAATTTTTACGTC
CAGGTCACTGCGCCATAGC->AGGTCACTGCGCCATAGCA
CAGGTGTACTAGTTCGAAT->AGGTGTACTAGTTCGAATA
CAGTAATAGTGCGGAAACC->AGTAATAGTGCGGAAACCC
CAGTATAATCACCTAAGAA->AGTATAATCACCTAAGAAG
CAGTCTACTAACAGATATT->AGTCTACTAACAGATATTG
CAGTGAATTCAGAACGCTC->AGTGAATTCAGAACGCTCA
CAGTGACATGAATTACACA->AGTGACATGAATTACACAG
CAGTGCGTCGTCTGGCCCA->AGTGCGTCGTCTGGCCCAC
CAGTTATGGCCTAAGGCGG->AGTTATGGCCTAAGGCGGT
CATAAATCAAATGGACTAT->ATAAATCAAATGGACTATA
CATACCGGAAACTGCTAAA->ATACCGGAAACTGCTAAAT
CATAGCAACAATGTGCCCT->ATAGCAACAATGTGCCCTC
CATCATGATCTTTGTCAGA->ATCATGATCTTTGTCAGAA
CATCGCACGCGGTACACAC->ATCGCACGCGGTACACACC
CATCTTACTACCTTTTCCT->ATCTTACTACCTTTTCCTT
CATCTTAGCCGAGCTATTA->ATCTTAGCCGAGCTATTAG
CATGAACTAAAACGGTCTC->ATGAACTAAAACGGTCTCG
CATGAATTACACAGATATG->ATGAATTACACAGATATGC
CATGACAATTGGAGTGCGC->ATGACAATTGGAGTGCGCT
CATGATCTTTGTCAGAAAG->ATGATCTTTGTCAGAAAGT
CATGCAAATGGCTGATTAC->ATGCAAATGGCTGATTACG
CATGCATAAATCAAATGGA->ATGCATAAATCAAATGGAC
CATGCGTACCCACAAAACC->ATGCGTACCCACAAAACCC
CATGCTACCCGATTAACGC->ATGCTACCCGATTAACGCG
CATGGGATGTGTAGATATT->ATGGGATGTGTAGATATTG
CATTACGAACGTACGACCG->ATTACGAACGTACGACCGC
CATTAGGTGCTAATCGTAC->ATTAGGTGCTAATCGTACA
CATTGATGCAGTGCGTCGT->ATTGATGCAGTGCGTCGTC
CATTGATTCTGCATTTATG->ATTGATTCTGCATTTATGA
CATTGTACAGTTATGGCCT->ATTGTACAGTTATGGCCTA
CATTTAACGGCTGTCTCGC->ATTTAACGGCTGTCTCGCC
CATTTATGATAACGAGAAA->ATTTATGATAACGAGAAAG
CATTTTATCTAAAAGCTCT->ATTTTATCTAAAAGCTCTA
CATTTTTTGACGAATCCAT->ATTTTTTGACGAATCCATG
CCAAACACTTCGGAACGGT->CAAACACTTCGGAACGGTG
CCAAACTCCGTCATGCATA->CAAACTCCGTCATGCATAA
CCAAATTCCATGGGATGTG->CAAATTCCATGGGATGTGT
CCAACCATCTTACTACCTT->CAACCATCTTACTACCTTT
CCAACGAACCTGTGGAGAG->CAACGAACCTGTGGAGAGA
CCAATTTTTACGTCGCATT->CAATTTTTACGTCGCATTG
CCACAAAACCCGCGTCCGG->CACAAAACCCGCGTCCGGC
CCACAACTCCTGCTAAGAT->CACAACTCCTGCTAAGATG
CCACAGTGACATGAATTAC->CACAGTGACATGAATTACA
CCACCCCTTCAAACCCATT->CACCCCTTCAAACCCATTA
CCACCTTGCACGAAAGGTG->CACCTTGCACGAAAGGTGT
CCACGAAGACCAGGATACG->CACGAAGACCAGGATACGC
CCACGCATTTTTTGACGAA->CACGCATTTTTTGACGAAT
CCACGCGAGGACGGGTTGG->CACGCGAGGACGGGTTGGT
CCACTTTCCATGAACTAAA->CACTTTCCATGAACTAAAA
CCAGAAATTCGCCGACCTA->CAGAAATTCGCCGACCTAG
CCAGACGTAGGTTAGTGCT->CAGACGTAGGTTAGTGCTG
CCAGAGATCACTCGGGCCC->CAGAGATCACTCGGGCCCT
CCAGCGGGTGTGAAAGATC->CAGCGGGTGTGAAAGATCT
CCAGCTCCCTGTCCCTAGG->CAGCTCCCTGTCCCTAGGC
CCAGGATACGCCTACGGAT->CAGGATACGCCTACGGATC
CCAGTAATAGTGCGGAAAC->CAGTAATAGTGCGGAAACC
CCAGTATAATCACCTAAGA->CAGTATAATCACCTAAGAA
CCATAGCAACAATGTGCCC->CATAGCAACAATGTGCCCT
CCATCTTACTACCTTTTCC->CATCTTACTACCTTTTCCT
CCATGAACTAAAACGGTCT->CATGAACTAAAACGGTCTC
CCATGCAAATGGCTGATTA->CATGCAAATGGCTGATTAC
CCATGCTACCCGATTAACG->CATGCTACCCGATTAACGC
CCATGGGATGTGTAGATAT->CATGGGATGTGTAGATATT
CCATTACGAACGTACGACC->CATTACGAACGTACGACCG
CCATTTAACGGCTGTCTCG->CATTTAACGGCTGTCTCGC
CCCACAAAACCCGCGTCCG->CCACAAAACCCGCGTCCGG
CCCACCTTGCACGAAAGGT->CCACCTTGCACGAAAGGTG
CCCACGAAGACCAGGATAC->CCACGAAGACCAGGATACG
CCCACGCATTTTTTGACGA->CCACGCATTTTTTGACGAA
CCCACGCGAGGACGGGTTG->CCACGCGAGGACGGGTTGG
CCCAGACGTAGGTTAGTGC->CCAGACGTAGGTTAGTGCT
CCCAGCTCCCTGTCCCTAG->CCAGCTCCCTGTCCCTAGG
CCCAGTATAATCACCTAAG->CCAGTATAATCACCTAAGA
CCCATTACGAACGTACGAC->CCATTACGAACGTACGACC
CCCATTTAACGGCTGTCTC->CCATTTAACGGCTGTCTCG
CCCCACCTTGCACGAAAGG->CCCACCTTGCACGAAAGGT
CCCCACGAAGACCAGGATA->CCCACGAAGACCAGGATAC
CCCCAGACGTAGGTTAGTG->CCCAGACGTAGGTTAGTGC
CCCCATTTAACGGCTGTCT->CCCATTTAACGGCTGTCTC
CCCCGCCCCTTCACTCGTG->CCCGCCCCTTCACTCGTGG
CCCCTAGGCCGCCCTGGTA->CCCTAGGCCGCCCTGGTAT
CCCCTTCAAACCCATTACG->CCCTTCAAACCCATTACGA
CCCCTTCACTCGTGGGTGG->CCCTTCACTCGTGGGTGGT
CCCGACGACGCAGGATCTT->CCGACGACGCAGGATCTTT
CCCGACTCAACACACAAAA->CCGACTCAACACACAAAAC
CCCGATTAACGCGCGAACA->CCGATTAACGCGCGAACAA
CCCGATTGATGTATGGTCA->CCGATTGATGTATGGTCAG
CCCGCCCCTTCACTCGTGG->CCGCCCCTTCACTCGTGGG
CCCGCGTCCGGCCCGATTG->CCGCGTCCGGCCCGATTGA
CCCGCGTCCGGCGTTGTCG->CCGCGTCCGGCGTTGTCGG
CCCGCGTCCGGCTAGTTCT->CCGCGTCCGGCTAGTTCTA
CCCGCGTCCGGCTCTATCC->CCGCGTCCGGCTCTATCCA
CCCGCTCGCTAGGCAGCAG->CCGCTCGCTAGGCAGCAGG
CCCTAAAAGGCCCCACGAA->CCTAAAAGGCCCCACGAAG
CCCTAGGCACATGCGTACC->CCTAGGCACATGCGTACCC
CCCTAGGCCCGACTCAACA->CCTAGGCCCGACTCAACAC
CCCTAGGCCGCCCTGGTAT->CCTAGGCCGCCCTGGTATC
CCCTAGGCGCAAAATTATT->CCTAGGCGCAAAATTATTC
CCCTAGGCTACAGAACGAT->CCTAGGCTACAGAACGATC
CCCTCCCCACCTTGCACGA->CCTCCCCACCTTGCACGAA
CCCTGGGGTTGCACAAATC->CCTGGGGTTGCACAAATCT
CCCTGGTATCGTAATCCGC->CCTGGTATCGTAATCCGCG
CCCTGTCCCTAGGCACATG->CCTGTCCCTAGGCACATGC
CCCTGTCCCTAGGCCCGAC->CCTGTCCCTAGGCCCGACT
CCCTGTCCCTAGGCGCAAA->CCTGTCCCTAGGCGCAAAA
CCCTGTCCCTAGGCTACAG->CCTGTCCCTAGGCTACAGA
CCCTTATAAGACAACCTAT->CCTTATAAGACAACCTATG
CCCTTCAAACCCATTACGA->CCTTCAAACCCATTACGAA
CCCTTCACTCGTGGGTGGT->CCTTCACTCGTGGGTGGTG
CCGAATAGGGCGCACACGC->CGAATAGGGCGCACACGCA
CCGACCTAGTACGGCTATT->CGACCTAGTACGGCTATTA
CCGACGACGCAGGATCTTT->CGACGACGCAGGATCTTTA
CCGACTCAACACACAAAAC->CGACTCAACACACAAAACC
CCGAGCTATTAGTCTTCCT->CGAGCTATTAGTCTTCCTT
CCGAGTTATATGTCCGTGC->CGAGTTATATGTCCGTGCA
CCGATCTGAATCCCAGCTC->CGATCTGAATCCCAGCTCC
CCGATTAACGCGCGAACAA->CGATTAACGCGCGAACAAT
CCGATTCGGATTGGCGCGG->CGATTCGGATTGGCGCGGA
CCGATTGATGTATGGTCAG->CGATTGATGTATGGTCAGA
CCGCAGCAGAACCTCTGAT->CGCAGCAGAACCTCTGATC
CCGCAGCTAGATGATTATC->CGCAGCTAGATGATTATCC
CCGCCCAGTATAATCACCT->CGCCCAGTATAATCACCTA
CCGCCCCTTCACTCGTGGG->CGCCCCTTCACTCGTGGGT
CCGCCCTGGTATCGTAATC->CGCCCTGGTATCGTAATCC
CCGCGACAGATGACGCTGC->CGCGACAGATGACGCTGCT
CCGCGCCACCCCTTCAAAC->CGCGCCACCCCTTCAAACC
CCGCGCCTGCACCAGATCG->CGCGCCTGCACCAGATCGC
CCGCGTCCGGCCCGATTGA->CGCGTCCGGCCCGATTGAT
CCGCGTCCGGCGTTGTCGG->CGCGTCCGGCGTTGTCGGA
CCGCGTCCGGCTAGTTCTA->CGCGTCCGGCTAGTTCTAT
CCGCGTCCGGCTCTATCCA->CGCGTCCGGCTCTATCCAG
CCGCTCGCTAGGCAGCAGG->CGCTCGCTAGGCAGCAGGT
CCGGAAACTGCTAAATGCA->CGGAAACTGCTAAATGCAG
CCGGACGACGAGGTATAAA->CGGACGACGAGGTATAAAG
CCGGCCCGATTGATGTATG->CGGCCCGATTGATGTATGG
CCGGCGGATAACCAAACTC->CGGCGGATAACCAAACTCC
CCGGCGTTGTCGGAACTAT->CGGCGTTGTCGGAACTATA
CCGGCTAGTTCTATCCGAT->CGGCTAGTTCTATCCGATT
CCGGCTCTATCCAGCGGGT->CGGCTCTATCCAGCGGGTG
CCGGCTTCTTCGCGCGCTC->CGGCTTCTTCGCGCGCTCC
CCGTCATGCATAAATCAAA->CGTCATGCATAAATCAAAT
CCGTGCAAACAGGATCACC->CGTGCAAACAGGATCACCA
CCTAAAAGGCCCCACGAAG->CTAAAAGGCCCCACGAAGA
CCTAAGAAGGAGGCAAACT->CTAAGAAGGAGGCAAACTT
CCTAAGCTCCCTGTCCCTA->CTAAGCTCCCTGTCCCTAG
CCTAAGGCGGTTTGAAGAT->CTAAGGCGGTTTGAAGATC
CCTACGGATCCACAACTCC->CTACGGATCCACAACTCCT
CCTACGGTACTAGCTCCCT->CTACGGTACTAGCTCCCTG
CCTACTCTTTGTCTCTGGG->CTACTCTTTGTCTCTGGGA
CCTAGAACTGCCGAGTTAT->CTAGAACTGCCGAGTTATA
CCTAGCGGCCGGCGGATAA->CTAGCGGCCGGCGGATAAC
CCTAGGCACATGCGTACCC->CTAGGCACATGCGTACCCA
CCTAGGCCCGACTCAACAC->CTAGGCCCGACTCAACACA
CCTAGGCCGCCCTGGTATC->CTAGGCCGCCCTGGTATCG
CCTAGGCGCAAAATTATTC->CTAGGCGCAAAATTATTCA
CCTAGGCTACAGAACGATC->CTAGGCTACAGAACGATCA
CCTAGTACGGCTATTATTC->CTAGTACGGCTATTATTCT
CCTATGTTACTTAATCCGC->CTATGTTACTTAATCCGCC
CCTCCAACGAACCTGTGGA->CTCCAACGAACCTGTGGAG
CCTCCCCACCTTGCACGAA->CTCCCCACCTTGCACGAAA
CCTCGCGTTCCTGCTTCAG->CTCGCGTTCCTGCTTCAGG
CCTCGGCTAACTAGCTCCC->CTCGGCTAACTAGCTCCCC
CCTCTGATCGGACACTCGG->CTCTGATCGGACACTCGGC
CCTGAGTGTGGCACCCTTA->CTGAGTGTGGCACCCTTAT
CCTGCATACCGGAAACTGC->CTGCATACCGGAAACTGCT
CCTGCTAAGATGACGCCTA->CTGCTAAGATGACGCCTAG
CCTGCTTCAGGTACCAATT->CTGCTTCAGGTACCAATTT
CCTGGAGCTAAGCTTGTGT->CTGGAGCTAAGCTTGTGTT
CCTGGAGGCTAGGCCTGGA->CTGGAGGCTAGGCCTGGAG
CCTGGCTTAGTAAAATCCC->CTGGCTTAGTAAAATCCCC
CCTGGGGTTGCACAAATCT->CTGGGGTTGCACAAATCTT
CCTGGTATCGTAATCCGCG->CTGGTATCGTAATCCGCGA
CCTGTCCCTAGGCACATGC->CTGTCCCTAGGCACATGCG
CCTGTCCCTAGGCCCGACT->CTGTCCCTAGGCCCGACTC
CCTGTCCCTAGGCGCAAAA->CTGTCCCTAGGCGCAAAAT
CCTGTCCCTAGGCTACAGA->CTGTCCCTAGGCTACAGAA
CCTGTGGAGAGAGTATACT->CTGTGGAGAGAGTATACTG
CCTGTGTATGGACCTAAGC->CTGTGTATGGACCTAAGCT
CCTTATAAGACAACCTATG->CTTATAAGACAACCTATGT
CCTTATCGCGGGTCACCAG->CTTATCGCGGGTCACCAGA
CCTTCAAACCCATTACGAA->CTTCAAACCCATTACGAAC
CCTTCACTCGTGGGTGGTG->CTTCACTCGTGGGTGGTGG
CCTTCAGCCTGCATACCGG->CTTCAGCCTGCATACCGGA
CCTTCAGGTCACTGCGCCA->CTTCAGGTCACTGCGCCAT
CCTTGCACGAAAGGTGTTC->CTTGCACGAAAGGTGTTCC
CCTTTTCCTTTTTAACTGT->CTTTTCCTTTTTAACTGTG
CCTTTTTAACTGTGGATGA->CTTTTTAACTGTGGATGAC
CGAAACCAGAGATCACTCG->GAAACCAGAGATCACTCGG
CGAAAGGTGTTCCAAATTC->GAAAGGTGTTCCAAATTCC
CGAACAATGACGAGCACCT->GAACAATGACGAGCACCTA
CGAACCTGTGGAGAGAGTA->GAACCTGTGGAGAGAGTAT
CGAACGTACGACCGCAGCA->GAACGTACGACCGCAGCAG
CGAAGACCAGGATACGCCT->GAAGACCAGGATACGCCTA
CGAATAAAAGCCTCGGCTA->GAATAAAAGCCTCGGCTAA
CGAATAGGGCGCACACGCA->GAATAGGGCGCACACGCAA
CGAATCCATGCTACCCGAT->GAATCCATGCTACCCGATT
CGACAGATGACGCTGCTCG->GACAGATGACGCTGCTCGA
CGACCGCAGCAGAACCTCT->GACCGCAGCAGAACCTCTG
CGACCTAGTACGGCTATTA->GACCTAGTACGGCTATTAT
CGACGACGCAGGATCTTTA->GACGACGCAGGATCTTTAC
CGACGAGGTATAAAGTTTT->GACGAGGTATAAAGTTTTT
CGACGCAGGATCTTTACGG->GACGCAGGATCTTTACGGA
CGACTCAACACACAAAACC->GACTCAACACACAAAACCC
CGAGAAAGTGACGCCCCAG->GAGAAAGTGACGCCCCAGA
CGAGAGAATGCATTGATGC->GAGAGAATGCATTGATGCA
CGAGCACCTACTCTTTGTC->GAGCACCTACTCTTTGTCT
CGAGCTATTAGTCTTCCTT->GAGCTATTAGTCTTCCTTA
CGAGGACGGGTTGGTGGCA->GAGGACGGGTTGGTGGCAT
CGAGGTATAAAGTTTTTTA->GAGGTATAAAGTTTTTTAG
CGAGTTATATGTCCGTGCA->GAGTTATATGTCCGTGCAA
CGATCACAAAACCCGCGTC->GATCACAAAACCCGCGTCC
CGATCTGAATCCCAGCTCC->GATCTGAATCCCAGCTCCC
CGATCTGTAATAGTCGGTC->GATCTGTAATAGTCGGTCG
CGATTAACGCGCGAACAAT->GATTAACGCGCGAACAATG
CGATTCGGATTGGCGCGGA->GATTCGGATTGGCGCGGAC
CGATTGATGTATGGTCAGA->GATTGATGTATGGTCAGAA
CGCAAAATTATTCACAAAA->GCAAAATTATTCACAAAAC
CGCAAGTATTCCAGTAATA->GCAAGTATTCCAGTAATAG
CGCACACGCAAGTATTCCA->GCACACGCAAGTATTCCAG
CGCACGCGGTACACACCTG->GCACGCGGTACACACCTGG
CGCACTCTGGGAAATATTC->GCACTCTGGGAAATATTCC
CGCAGCAGAACCTCTGATC->GCAGCAGAACCTCTGATCG
CGCAGCTAGATGATTATCC->GCAGCTAGATGATTATCCC
CGCAGGATCTTTACGGAGG->GCAGGATCTTTACGGAGGG
CGCAGTCTACTAACAGATA->GCAGTCTACTAACAGATAT
CGCAGTGAATTCAGAACGC->GCAGTGAATTCAGAACGCT
CGCATGACAATTGGAGTGC->GCATGACAATTGGAGTGCG
CGCATTGATTCTGCATTTA->GCATTGATTCTGCATTTAT
CGCATTTTTTGACGAATCC->GCATTTTTTGACGAATCCA
CGCCACCCCTTCAAACCCA->GCCACCCCTTCAAACCCAT
CGCCATAGCAACAATGTGC->GCCATAGCAACAATGTGCC
CGCCCAGTATAATCACCTA->GCCCAGTATAATCACCTAA
CGCCCCAGACGTAGGTTAG->GCCCCAGACGTAGGTTAGT
CGCCCCTTCACTCGTGGGT->GCCCCTTCACTCGTGGGTG
CGCCCTGGTATCGTAATCC->GCCCTGGTATCGTAATCCG
CGCCGACCTAGTACGGCTA->GCCGACCTAGTACGGCTAT
CGCCTACGGATCCACAACT->GCCTACGGATCCACAACTC
CGCCTAGAACTGCCGAGTT->GCCTAGAACTGCCGAGTTA
CGCCTAGCGGCCGGCGGAT->GCCTAGCGGCCGGCGGATA
CGCCTGTGTATGGACCTAA->GCCTGTGTATGGACCTAAG
CGCGAACAATGACGAGCAC->GCGAACAATGACGAGCACC
CGCGACAGATGACGCTGCT->GCGACAGATGACGCTGCTC
CGCGAGGACGGGTTGGTGG->GCGAGGACGGGTTGGTGGC
CGCGCCACCCCTTCAAACC->GCGCCACCCCTTCAAACCC
CGCGCGAACAATGACGAGC->GCGCGAACAATGACGAGCA
CGCGCGCTCCCGACGACGC->GCGCGCTCCCGACGACGCA
CGCGCTCCCGACGACGCAG->GCGCTCCCGACGACGCAGG
CGCGGACTAGGCGCGTTAG->GCGGACTAGGCGCGTTAGG
CGCGGGATTTCGCAGTGAA->GCGGGATTTCGCAGTGAAT
CGCGGGTCACCAGAAATTC->GCGGGTCACCAGAAATTCG
CGCGGTACACACCTGGAGG->GCGGTACACACCTGGAGGC
CGCGTCCGGCCCGATTGAT->GCGTCCGGCCCGATTGATG
CGCGTCCGGCGTTGTCGGA->GCGTCCGGCGTTGTCGGAA
CGCGTCCGGCTAGTTCTAT->GCGTCCGGCTAGTTCTATC
CGCGTCCGGCTCTATCCAG->GCGTCCGGCTCTATCCAGC
CGCGTCGTTAGCCTTCAGC->GCGTCGTTAGCCTTCAGCC
CGCGTTAGGGGCGTCGTCG->GCGTTAGGGGCGTCGTCGC
CGCGTTCCTGCTTCAGGTA->GCGTTCCTGCTTCAGGTAC
CGCTAGACTGGATTTGCAC->GCTAGACTGGATTTGCACA
CGCTAGGCAGCAGGTGTAC->GCTAGGCAGCAGGTGTACT
CGCTATGACTGGAGGAGAG->GCTATGACTGGAGGAGAGC
CGCTCATTTTATCTAAAAG->GCTCATTTTATCTAAAAGC
CGCTCCCGACGACGCAGGA->GCTCCCGACGACGCAGGAT
CGCTCGCTAGGCAGCAGGT->GCTCGCTAGGCAGCAGGTG
CGCTGCTCGAGAGAATGCA->GCTGCTCGAGAGAATGCAT
CGCTTCTATTACGGACGTT->GCTTCTATTACGGACGTTG
CGCTTTGCGGGCTAGCCTC->GCTTTGCGGGCTAGCCTCG
CGGAAACCCCATTTAACGG->GGAAACCCCATTTAACGGC
CGGAAACTGCTAAATGCAG->GGAAACTGCTAAATGCAGG
CGGAACGGTGTGGGACGTT->GGAACGGTGTGGGACGTTT
CGGAACTATAGCTTCTAAA->GGAACTATAGCTTCTAAAA
CGGACACTCGGCGGGAACG->GGACACTCGGCGGGAACGC
CGGACCACAGTGACATGAA->GGACCACAGTGACATGAAT
CGGACGACGAGGTATAAAG->GGACGACGAGGTATAAAGT
CGGACGTTGGCATTAGGTG->GGACGTTGGCATTAGGTGC
CGGACTAGGCGCGTTAGGG->GGACTAGGCGCGTTAGGGG
CGGAGGGAACGCACTCTGG->GGAGGGAACGCACTCTGGG
CGGATAACCAAACTCCGTC->GGATAACCAAACTCCGTCA
CGGATCCACAACTCCTGCT->GGATCCACAACTCCTGCTA
CGGATTGGCGCGGACTAGG->GGATTGGCGCGGACTAGGC
CGGCAAGTTATCTTCATCA->GGCAAGTTATCTTCATCAT
CGGCCCGATTGATGTATGG->GGCCCGATTGATGTATGGT
CGGCCGGCGGATAACCAAA->GGCCGGCGGATAACCAAAC
CGGCGGATAACCAAACTCC->GGCGGATAACCAAACTCCG
CGGCGGGAACGCTATGACT->GGCGGGAACGCTATGACTG
CGGCGTTGTCGGAACTATA->GGCGTTGTCGGAACTATAG
CGGCTAACTAGCTCCCCGC->GGCTAACTAGCTCCCCGCC
CGGCTAGTTCTATCCGATT->GGCTAGTTCTATCCGATTC
CGGCTATTATTCTGAAATT->GGCTATTATTCTGAAATTT
CGGCTCTATCCAGCGGGTG->GGCTCTATCCAGCGGGTGT
CGGCTGTCTCGCCTAGCGG->GGCTGTCTCGCCTAGCGGC
CGGCTTCTTCGCGCGCTCC->GGCTTCTTCGCGCGCTCCC
CGGGAACGCTATGACTGGA->GGGAACGCTATGACTGGAG
CGGGATTTCGCAGTGAATT->GGGATTTCGCAGTGAATTC
CGGGCCCTAAAAGGCCCCA->GGGCCCTAAAAGGCCCCAC
CGGGCTAGCCTCGCGTTCC->GGGCTAGCCTCGCGTTCCT
CGGGTCACCAGAAATTCGC->GGGTCACCAGAAATTCGCC
CGGGTGTGAAAGATCTACG->GGGTGTGAAAGATCTACGC
CGGGTTGGTGGCATCGCAC->GGGTTGGTGGCATCGCACG
CGGTACACACCTGGAGGCT->GGTACACACCTGGAGGCTA
CGGTACTAGCTCCCTGTCC->GGTACTAGCTCCCTGTCCC
CGGTCGGCAAGTTATCTTC->GGTCGGCAAGTTATCTTCA
CGGTCGTAAAGGGAGAGGC->GGTCGTAAAGGGAGAGGCT
CGGTCTCGCGGGATTTCGC->GGTCTCGCGGGATTTCGCA
CGGTGTGGGACGTTTTGTG->GGTGTGGGACGTTTTGTGA
CGGTTTGAAGATCCAAACA->GGTTTGAAGATCCAAACAC
CGTAAAGGGAGAGGCTCGG->GTAAAGGGAGAGGCTCGGA
CGTAATCCGCGACAGATGA->GTAATCCGCGACAGATGAC
CGTACAGCTACACCTTCAG->GTACAGCTACACCTTCAGG
CGTACCCACAAAACCCGCG->GTACCCACAAAACCCGCGT
CGTACGACCGCAGCAGAAC->GTACGACCGCAGCAGAACC
CGTAGGTTAGTGCTGACCG->GTAGGTTAGTGCTGACCGC
CGTCATGCATAAATCAAAT->GTCATGCATAAATCAAATG
CGTCCGGCCCGATTGATGT->GTCCGGCCCGATTGATGTA
CGTCCGGCGTTGTCGGAAC->GTCCGGCGTTGTCGGAACT
CGTCCGGCTAGTTCTATCC->GTCCGGCTAGTTCTATCCG
CGTCCGGCTCTATCCAGCG->GTCCGGCTCTATCCAGCGG
CGTCGCATTGATTCTGCAT->GTCGCATTGATTCTGCATT
CGTCGCGTCGTTAGCCTTC->GTCGCGTCGTTAGCCTTCA
CGTCGTCGCGTCGTTAGCC->GTCGTCGCGTCGTTAGCCT
CGTCGTCTGGCCCACGCGA->GTCGTCTGGCCCACGCGAG
CGTCGTTAGCCTTCAGCCT->GTCGTTAGCCTTCAGCCTG
CGTCTGGCCCACGCGAGGA->GTCTGGCCCACGCGAGGAC
CGTGCAAACAGGATCACCA->GTGCAAACAGGATCACCAC
CGTGGGTGGTGGGCCGATC->GTGGGTGGTGGGCCGATCT
CGTTAGCCTTCAGCCTGCA->GTTAGCCTTCAGCCTGCAT
CGTTAGGGGCGTCGTCGCG->GTTAGGGGCGTCGTCGCGT
CGTTCCTGCTTCAGGTACC->GTTCCTGCTTCAGGTACCA
CGTTGGCATTAGGTGCTAA->GTTGGCATTAGGTGCTAAT
CGTTGTCGGAACTATAGCT->GTTGTCGGAACTATAGCTT
CGTTTTGTGAGGGGGCCCT->GTTTTGTGAGGGGGCCCTG
CTAAAACGGTCTCGCGGGA->TAAAACGGTCTCGCGGGAT
CTAAAAGCTCTACTGGTAA->TAAAAGCTCTACTGGTAAT
CTAAAAGGCCCCACGAAGA->TAAAAGGCCCCACGAAGAC
CTAAAAGTCTAACAGACTA->TAAAAGTCTAACAGACTAA
CTAAATGCAGGACCATGCA->TAAATGCAGGACCATGCAA
CTAACAGACTAAGTTGGAT->TAACAGACTAAGTTGGATT
CTAACAGATATTGACCGGA->TAACAGATATTGACCGGAC
CTAACTAGCTCCCCGCCCC->TAACTAGCTCCCCGCCCCT
CTAAGAAGGAGGCAAACTT->TAAGAAGGAGGCAAACTTC
CTAAGATGACGCCTAGAAC->TAAGATGACGCCTAGAACT
CTAAGCTCCCTGTCCCTAG->TAAGCTCCCTGTCCCTAGG
CTAAGCTTGTGTTAGCACG->TAAGCTTGTGTTAGCACGC
CTAAGGCGGTTTGAAGATC->TAAGGCGGTTTGAAGATCC
CTAAGTTGGATTGGGGGGA->TAAGTTGGATTGGGGGGAA
CTAATCGTACAGCTACACC->TAATCGTACAGCTACACCT
CTACACCTTCAGGTCACTG->TACACCTTCAGGTCACTGC
CTACAGAACGATCACAAAA->TACAGAACGATCACAAAAC
CTACCCGATTAACGCGCGA->TACCCGATTAACGCGCGAA
CTACCTTTTCCTTTTTAAC->TACCTTTTCCTTTTTAACT
CTACGCAGTCTACTAACAG->TACGCAGTCTACTAACAGA
CTACGGATCCACAACTCCT->TACGGATCCACAACTCCTG
CTACGGTACTAGCTCCCTG->TACGGTACTAGCTCCCTGT
CTACTAACAGATATTGACC->TACTAACAGATATTGACCG
CTACTCTTTGTCTCTGGGA->TACTCTTTGTCTCTGGGAA
CTACTGGTAATTAGATATA->TACTGGTAATTAGATATAC
CTAGAACTGCCGAGTTATA->TAGAACTGCCGAGTTATAT
CTAGACTGGATTTGCACAC->TAGACTGGATTTGCACACC
CTAGATGATTATCCCACGC->TAGATGATTATCCCACGCA
CTAGCCTCGCGTTCCTGCT->TAGCCTCGCGTTCCTGCTT
CTAGCGGCCGGCGGATAAC->TAGCGGCCGGCGGATAACC
CTAGCTCCCCGCCCCTTCA->TAGCTCCCCGCCCCTTCAC
CTAGCTCCCTGTCCCTAGG->TAGCTCCCTGTCCCTAGGC
CTAGGAGCTCCCTGTCCCT->TAGGAGCTCCCTGTCCCTA
CTAGGCACATGCGTACCCA->TAGGCACATGCGTACCCAC
CTAGGCAGCAGGTGTACTA->TAGGCAGCAGGTGTACTAG
CTAGGCCCGACTCAACACA->TAGGCCCGACTCAACACAC
CTAGGCCGCCCTGGTATCG->TAGGCCGCCCTGGTATCGT
CTAGGCCTGGAGCTAAGCT->TAGGCCTGGAGCTAAGCTT
CTAGGCGCAAAATTATTCA->TAGGCGCAAAATTATTCAC
CTAGGCGCGTTAGGGGCGT->TAGGCGCGTTAGGGGCGTC
CTAGGCTACAGAACGATCA->TAGGCTACAGAACGATCAC
CTAGTACGGCTATTATTCT->TAGTACGGCTATTATTCTG
CTAGTTCGAATAAAAGCCT->TAGTTCGAATAAAAGCCTC
CTAGTTCTATCCGATTCGG->TAGTTCTATCCGATTCGGA
CTATAAGAATATTCCTGAG->TATAAGAATATTCCTGAGT
CTATAGCTTCTAAAAGTCT->TATAGCTTCTAAAAGTCTA
CTATCCAGCGGGTGTGAAA->TATCCAGCGGGTGTGAAAG
CTATCCGATTCGGATTGGC->TATCCGATTCGGATTGGCG
CTATGACTGGAGGAGAGCA->TATGACTGGAGGAGAGCAT
CTATGTTACTTAATCCGCC->TATGTTACTTAATCCGCCC
CTATTACGGACGTTGGCAT->TATTACGGACGTTGGCATT
CTATTAGTCTTCCTTATCG->TATTAGTCTTCCTTATCGC
CTATTATTCTGAAATTTGC->TATTATTCTGAAATTTGCC
CTCAACACACAAAACCCGC->TCAACACACAAAACCCGCG
CTCACTTTAAGTCAGATGC->TCACTTTAAGTCAGATGCC
CTCATTTTATCTAAAAGCT->TCATTTTATCTAAAAGCTC
CTCCAACGAACCTGTGGAG->TCCAACGAACCTGTGGAGA
CTCCCCACCTTGCACGAAA->TCCCCACCTTGCACGAAAG
CTCCCCGCCCCTTCACTCG->TCCCCGCCCCTTCACTCGT
CTCCCGACGACGCAGGATC->TCCCGACGACGCAGGATCT
CTCCCTGTCCCTAGGCACA->TCCCTGTCCCTAGGCACAT
CTCCCTGTCCCTAGGCCCG->TCCCTGTCCCTAGGCCCGA
CTCCCTGTCCCTAGGCGCA->TCCCTGTCCCTAGGCGCAA
CTCCCTGTCCCTAGGCTAC->TCCCTGTCCCTAGGCTACA
CTCCGTCATGCATAAATCA->TCCGTCATGCATAAATCAA
CTCCTGCTAAGATGACGCC->TCCTGCTAAGATGACGCCT
CTCGAGAGAATGCATTGAT->TCGAGAGAATGCATTGATG
CTCGCCTAGCGGCCGGCGG->TCGCCTAGCGGCCGGCGGA
CTCGCCTGTGTATGGACCT->TCGCCTGTGTATGGACCTA
CTCGCGGGATTTCGCAGTG->TCGCGGGATTTCGCAGTGA
CTCGCGTTCCTGCTTCAGG->TCGCGTTCCTGCTTCAGGT
CTCGCTAGGCAGCAGGTGT->TCGCTAGGCAGCAGGTGTA
CTCGGACCACAGTGACATG->TCGGACCACAGTGACATGA
CTCGGCGGGAACGCTATGA->TCGGCGGGAACGCTATGAC
CTCGGCTAACTAGCTCCCC->TCGGCTAACTAGCTCCCCG
CTCGGGCCCTAAAAGGCCC->TCGGGCCCTAAAAGGCCCC
CTCGTGGGTGGTGGGCCGA->TCGTGGGTGGTGGGCCGAT
CTCTACTGGTAATTAGATA->TCTACTGGTAATTAGATAT
CTCTATCCAGCGGGTGTGA->TCTATCCAGCGGGTGTGAA
CTCTCGCCTGTGTATGGAC->TCTCGCCTGTGTATGGACC
CTCTGATCGGACACTCGGC->TCTGATCGGACACTCGGCG
CTCTGGGAAATATTCCTCC->TCTGGGAAATATTCCTCCA
CTCTGGGAATGATCAAGCT->TCTGGGAATGATCAAGCTC
CTCTTTGTCTCTGGGAATG->TCTTTGTCTCTGGGAATGA
CTGAAATTTGCCCGCTCGC->TGAAATTTGCCCGCTCGCT
CTGAATCCCAGCTCCCTGT->TGAATCCCAGCTCCCTGTC
CTGACCGCGCCTGCACCAG->TGACCGCGCCTGCACCAGA
CTGAGCGATCTGTAATAGT->TGAGCGATCTGTAATAGTC
CTGAGTGTGGCACCCTTAT->TGAGTGTGGCACCCTTATA
CTGATCGGACACTCGGCGG->TGATCGGACACTCGGCGGG
CTGATTACGAAACCAGAGA->TGATTACGAAACCAGAGAT
CTGCATACCGGAAACTGCT->TGCATACCGGAAACTGCTA
CTGCATTTATGATAACGAG->TGCATTTATGATAACGAGA
CTGCCGAGTTATATGTCCG->TGCCGAGTTATATGTCCGT
CTGCGCCATAGCAACAATG->TGCGCCATAGCAACAATGT
CTGCTAAATGCAGGACCAT->TGCTAAATGCAGGACCATG
CTGCTAAGATGACGCCTAG->TGCTAAGATGACGCCTAGA
CTGCTCGAGAGAATGCATT->TGCTCGAGAGAATGCATTG
CTGCTCTCGCCTGTGTATG->TGCTCTCGCCTGTGTATGG
CTGCTTCAGGTACCAATTT->TGCTTCAGGTACCAATTTT
CTGGAGCTAAGCTTGTGTT->TGGAGCTAAGCTTGTGTTA
CTGGAGGAGAGCATTGTAC->TGGAGGAGAGCATTGTACA
CTGGAGGCTAGGCCTGGAG->TGGAGGCTAGGCCTGGAGC
CTGGATTTGCACACCGCAG->TGGATTTGCACACCGCAGC
CTGGCCCACGCGAGGACGG->TGGCCCACGCGAGGACGGG
CTGGCTTAGTAAAATCCCC->TGGCTTAGTAAAATCCCCT
CTGGGAAATATTCCTCCAA->TGGGAAATATTCCTCCAAC
CTGGGAATGATCAAGCTCA->TGGGAATGATCAAGCTCAC
CTGGGGTTGCACAAATCTT->TGGGGTTGCACAAATCTTG
CTGGTAATTAGATATACCT->TGGTAATTAGATATACCTA
CTGGTATCGTAATCCGCGA->TGGTATCGTAATCCGCGAC
CTGGTGATCAACCAACCAT->TGGTGATCAACCAACCATC
CTGTAATAGTCGGTCGGCA->TGTAATAGTCGGTCGGCAA
CTGTATGTTCCGCGCCACC->TGTATGTTCCGCGCCACCC
CTGTCCCTAGGCACATGCG->TGTCCCTAGGCACATGCGT
CTGTCCCTAGGCCCGACTC->TGTCCCTAGGCCCGACTCA
CTGTCCCTAGGCGCAAAAT->TGTCCCTAGGCGCAAAATT
CTGTCCCTAGGCTACAGAA->TGTCCCTAGGCTACAGAAC
CTGTCTCGCCTAGCGGCCG->TGTCTCGCCTAGCGGCCGG
CTGTGGAGAGAGTATACTG->TGTGGAGAGAGTATACTGG
CTGTGGATGACTTCATCTT->TGTGGATGACTTCATCTTA
CTGTGTATGGACCTAAGCT->TGTGTATGGACCTAAGCTC
CTTAATCCGCCCAGTATAA->TTAATCCGCCCAGTATAAT
CTTACTACCTTTTCCTTTT->TTACTACCTTTTCCTTTTT
CTTAGCCGAGCTATTAGTC->TTAGCCGAGCTATTAGTCT
CTTAGTAAAATCCCCTAGG->TTAGTAAAATCCCCTAGGC
CTTATAAGACAACCTATGT->TTATAAGACAACCTATGTT
CTTATCGCGGGTCACCAGA->TTATCGCGGGTCACCAGAA
CTTCAAACCCATTACGAAC->TTCAAACCCATTACGAACG
CTTCACTCGTGGGTGGTGG->TTCACTCGTGGGTGGTGGG
CTTCAGCCTGCATACCGGA->TTCAGCCTGCATACCGGAA
CTTCAGGTACCAATTTTTA->TTCAGGTACCAATTTTTAC
CTTCAGGTCACTGCGCCAT->TTCAGGTCACTGCGCCATA
CTTCATCATGATCTTTGTC->TTCATCATGATCTTTGTCA
CTTCATCTTAGCCGAGCTA->TTCATCTTAGCCGAGCTAT
CTTCCTTATCGCGGGTCAC->TTCCTTATCGCGGGTCACC
CTTCGCGCGCTCCCGACGA->TTCGCGCGCTCCCGACGAC
CTTCGGAACGGTGTGGGAC->TTCGGAACGGTGTGGGACG
CTTCTAAAAGTCTAACAGA->TTCTAAAAGTCTAACAGAC
CTTCTATTACGGACGTTGG->TTCTATTACGGACGTTGGC
CTTCTGTATGTTCCGCGCC->TTCTGTATGTTCCGCGCCA
CTTCTTCGCGCGCTCCCGA->TTCTTCGCGCGCTCCCGAC
CTTGCACGAAAGGTGTTCC->TTGCACGAAAGGTGTTCCA
CTTGTCGCTAGACTGGATT->TTGTCGCTAGACTGGATTT
CTTGTGTTAGCACGCTTTG->TTGTGTTAGCACGCTTTGC
CTTTAAGTCAGATGCCGGC->TTTAAGTCAGATGCCGGCT
CTTTACGGAGGGAACGCAC->TTTACGGAGGGAACGCACT
CTTTCCATGAACTAAAACG->TTTCCATGAACTAAAACGG
CTTTGCGGGCTAGCCTCGC->TTTGCGGGCTAGCCTCGCG
CTTTGTCAGAAAGTCCGAA->TTTGTCAGAAAGTCCGAAT
CTTTGTCTCTGGGAATGAT->TTTGTCTCTGGGAATGATC
CTTTTCCTTTTTAACTGTG->TTTTCCTTTTTAACTGTGG
CTTTTTAACTGTGGATGAC->TTTTTAACTGTGGATGACT
GAAACCAGAGATCACTCGG->AAACCAGAGATCACTCGGG
GAAACCCCATTTAACGGCT->AAACCCCATTTAACGGCTG
GAAACTGCTAAATGCAGGA->AAACTGCTAAATGCAGGAC
GAAAGATCTACGCAGTCTA->AAAGATCTACGCAGTCTAC
GAAAGGTGTTCCAAATTCC->AAAGGTGTTCCAAATTCCA
GAAAGTCCGAATAGGGCGC->AAAGTCCGAATAGGGCGCA
GAAAGTGACGCCCCAGACG->AAAGTGACGCCCCAGACGT
GAAATATTCCTCCAACGAA->AAATATTCCTCCAACGAAC
GAAATTCGCCGACCTAGTA->AAATTCGCCGACCTAGTAC
GAAATTCTAGGAGCTCCCT->AAATTCTAGGAGCTCCCTG
GAAATTTGCCCGCTCGCTA->AAATTTGCCCGCTCGCTAG
GAACAATGACGAGCACCTA->AACAATGACGAGCACCTAC
GAACAGGAAATTCTAGGAG->AACAGGAAATTCTAGGAGC
GAACAGGAAGGGGACGCAT->AACAGGAAGGGGACGCATG
GAACCTCTGATCGGACACT->AACCTCTGATCGGACACTC
GAACCTGTGGAGAGAGTAT->AACCTGTGGAGAGAGTATA
GAACGATCACAAAACCCGC->AACGATCACAAAACCCGCG
GAACGCACTCTGGGAAATA->AACGCACTCTGGGAAATAT
GAACGCTATGACTGGAGGA->AACGCTATGACTGGAGGAG
GAACGCTCATTTTATCTAA->AACGCTCATTTTATCTAAA
GAACGGTGTGGGACGTTTT->AACGGTGTGGGACGTTTTG
GAACGTACGACCGCAGCAG->AACGTACGACCGCAGCAGA
GAACTAAAACGGTCTCGCG->AACTAAAACGGTCTCGCGG
GAACTATAGCTTCTAAAAG->AACTATAGCTTCTAAAAGT
GAACTGCCGAGTTATATGT->AACTGCCGAGTTATATGTC
GAAGACCAGGATACGCCTA->AAGACCAGGATACGCCTAC
GAAGATCCAAACACTTCGG->AAGATCCAAACACTTCGGA
GAAGGAGGCAAACTTCTGT->AAGGAGGCAAACTTCTGTA
GAAGGGGACGCATGACAAT->AAGGGGACGCATGACAATT
GAATAAAAGCCTCGGCTAA->AATAAAAGCCTCGGCTAAC
GAATAGGGCGCACACGCAA->AATAGGGCGCACACGCAAG
GAATATTCCTGAGTGTGGC->AATATTCCTGAGTGTGGCA
GAATCCATGCTACCCGATT->AATCCATGCTACCCGATTA
GAATCCCAGCTCCCTGTCC->AATCCCAGCTCCCTGTCCC
GAATGATCAAGCTCACTTT->AATGATCAAGCTCACTTTA
GAATGCATTGATGCAGTGC->AATGCATTGATGCAGTGCG
GAATTACACAGATATGCTG->AATTACACAGATATGCTGC
GAATTCAGAACGCTCATTT->AATTCAGAACGCTCATTTT
GACAACCTATGTTACTTAA->ACAACCTATGTTACTTAAT
GACAATTGGAGTGCGCTTC->ACAATTGGAGTGCGCTTCT
GACACTCGGCGGGAACGCT->ACACTCGGCGGGAACGCTA
GACAGATGACGCTGCTCGA->ACAGATGACGCTGCTCGAG
GACATGAATTACACAGATA->ACATGAATTACACAGATAT
GACCACAGTGACATGAATT->ACCACAGTGACATGAATTA
GACCAGGATACGCCTACGG->ACCAGGATACGCCTACGGA
GACCATGCAAATGGCTGAT->ACCATGCAAATGGCTGATT
GACCGCAGCAGAACCTCTG->ACCGCAGCAGAACCTCTGA
GACCGCGCCTGCACCAGAT->ACCGCGCCTGCACCAGATC
GACCGGACGACGAGGTATA->ACCGGACGACGAGGTATAA
GACCTAAGCTCCCTGTCCC->ACCTAAGCTCCCTGTCCCT
GACCTAGTACGGCTATTAT->ACCTAGTACGGCTATTATT
GACGAATCCATGCTACCCG->ACGAATCCATGCTACCCGA
GACGACGAGGTATAAAGTT->ACGACGAGGTATAAAGTTT
GACGACGCAGGATCTTTAC->ACGACGCAGGATCTTTACG
GACGAGCACCTACTCTTTG->ACGAGCACCTACTCTTTGT
GACGAGGTATAAAGTTTTT->ACGAGGTATAAAGTTTTTT
GACGCAGGATCTTTACGGA->ACGCAGGATCTTTACGGAG
GACGCATGACAATTGGAGT->ACGCATGACAATTGGAGTG
GACGCCCCAGACGTAGGTT->ACGCCCCAGACGTAGGTTA
GACGCCTAGAACTGCCGAG->ACGCCTAGAACTGCCGAGT
GACGCTGCTCGAGAGAATG->ACGCTGCTCGAGAGAATGC
GACGGGTTGGTGGCATCGC->ACGGGTTGGTGGCATCGCA
GACGTAGGTTAGTGCTGAC->ACGTAGGTTAGTGCTGACC
GACGTTGGCATTAGGTGCT->ACGTTGGCATTAGGTGCTA
GACGTTTTGTGAGGGGGCC->ACGTTTTGTGAGGGGGCCC
GACTAAGTTGGATTGGGGG->ACTAAGTTGGATTGGGGGG
GACTAGGCGCGTTAGGGGC->ACTAGGCGCGTTAGGGGCG
GACTATAAGAATATTCCTG->ACTATAAGAATATTCCTGA
GACTCAACACACAAAACCC->ACTCAACACACAAAACCCG
GACTGGAGGAGAGCATTGT->ACTGGAGGAGAGCATTGTA
GACTGGATTTGCACACCGC->ACTGGATTTGCACACCGCA
GACTTCATCTTAGCCGAGC->ACTTCATCTTAGCCGAGCT
GAGAAAGTGACGCCCCAGA->AGAAAGTGACGCCCCAGAC
GAGAATGCATTGATGCAGT->AGAATGCATTGATGCAGTG
GAGAGAATGCATTGATGCA->AGAGAATGCATTGATGCAG
GAGAGAGTATACTGGTGAT->AGAGAGTATACTGGTGATC
GAGAGCATTGTACAGTTAT->AGAGCATTGTACAGTTATG
GAGAGGCTCGGACCACAGT->AGAGGCTCGGACCACAGTG
GAGAGTATACTGGTGATCA->AGAGTATACTGGTGATCAA
GAGATCACTCGGGCCCTAA->AGATCACTCGGGCCCTAAA
GAGCACCTACTCTTTGTCT->AGCACCTACTCTTTGTCTC
GAGCATTGTACAGTTATGG->AGCATTGTACAGTTATGGC
GAGCGATCTGTAATAGTCG->AGCGATCTGTAATAGTCGG
GAGCTAAGCTTGTGTTAGC->AGCTAAGCTTGTGTTAGCA
GAGCTATTAGTCTTCCTTA->AGCTATTAGTCTTCCTTAT
GAGCTCCCTGTCCCTAGGC->AGCTCCCTGTCCCTAGGCG
GAGGACGGGTTGGTGGCAT->AGGACGGGTTGGTGGCATC
GAGGAGAGCATTGTACAGT->AGGAGAGCATTGTACAGTT
GAGGCAAACTTCTGTATGT->AGGCAAACTTCTGTATGTT
GAGGCTAGGCCTGGAGCTA->AGGCTAGGCCTGGAGCTAA
GAGGCTCGGACCACAGTGA->AGGCTCGGACCACAGTGAC
GAGGGAACGCACTCTGGGA->AGGGAACGCACTCTGGGAA
GAGGGGGCCCTGGGGTTGC->AGGGGGCCCTGGGGTTGCA
GAGGTATAAAGTTTTTTAG->AGGTATAAAGTTTTTTAGG
GAGTATACTGGTGATCAAC->AGTATACTGGTGATCAACC
GAGTGCGCTTCTATTACGG->AGTGCGCTTCTATTACGGA
GAGTGTGGCACCCTTATAA->AGTGTGGCACCCTTATAAG
GAGTTATATGTCCGTGCAA->AGTTATATGTCCGTGCAAA
GATAACCAAACTCCGTCAT->ATAACCAAACTCCGTCATG
GATAACGAGAAAGTGACGC->ATAACGAGAAAGTGACGCC
GATACGCCTACGGATCCAC->ATACGCCTACGGATCCACA
GATATACCTACGGTACTAG->ATATACCTACGGTACTAGC
GATATGCTGCTCTCGCCTG->ATATGCTGCTCTCGCCTGT
GATATTGACCGGACGACGA->ATATTGACCGGACGACGAG
GATATTGTCAAAGCTGAGC->ATATTGTCAAAGCTGAGCG
GATCAACCAACCATCTTAC->ATCAACCAACCATCTTACT
GATCAAGCTCACTTTAAGT->ATCAAGCTCACTTTAAGTC
GATCACAAAACCCGCGTCC->ATCACAAAACCCGCGTCCG
GATCACCACTTTCCATGAA->ATCACCACTTTCCATGAAC
GATCACTCGGGCCCTAAAA->ATCACTCGGGCCCTAAAAG
GATCCAAACACTTCGGAAC->ATCCAAACACTTCGGAACG
GATCCACAACTCCTGCTAA->ATCCACAACTCCTGCTAAG
GATCGGACACTCGGCGGGA->ATCGGACACTCGGCGGGAA
GATCTACGCAGTCTACTAA->ATCTACGCAGTCTACTAAC
GATCTGAATCCCAGCTCCC->ATCTGAATCCCAGCTCCCT
GATCTGTAATAGTCGGTCG->ATCTGTAATAGTCGGTCGG
GATCTTTACGGAGGGAACG->ATCTTTACGGAGGGAACGC
GATCTTTGTCAGAAAGTCC->ATCTTTGTCAGAAAGTCCG
GATGACGCCTAGAACTGCC->ATGACGCCTAGAACTGCCG
GATGACGCTGCTCGAGAGA->ATGACGCTGCTCGAGAGAA
GATGACTTCATCTTAGCCG->ATGACTTCATCTTAGCCGA
GATGATTATCCCACGCATT->ATGATTATCCCACGCATTT
GATGCAGTGCGTCGTCTGG->ATGCAGTGCGTCGTCTGGC
GATGCCGGCTTCTTCGCGC->ATGCCGGCTTCTTCGCGCG
GATGTATGGTCAGAACAGG->ATGTATGGTCAGAACAGGA
GATGTGTAGATATTGTCAA->ATGTGTAGATATTGTCAAA
GATTAACGCGCGAACAATG->ATTAACGCGCGAACAATGA
GATTACGAAACCAGAGATC->ATTACGAAACCAGAGATCA
GATTATCCCACGCATTTTT->ATTATCCCACGCATTTTTT
GATTCGGATTGGCGCGGAC->ATTCGGATTGGCGCGGACT
GATTCTGCATTTATGATAA->ATTCTGCATTTATGATAAC
GATTGATGTATGGTCAGAA->ATTGATGTATGGTCAGAAC
GATTGGCGCGGACTAGGCG->ATTGGCGCGGACTAGGCGC
GATTGGGGGGAACAGGAAA->ATTGGGGGGAACAGGAAAT
GATTTCGCAGTGAATTCAG->ATTTCGCAGTGAATTCAGA
GATTTGCACACCGCAGCTA->ATTTGCACACCGCAGCTAG
GCAAAATTATTCACAAAAC->CAAAATTATTCACAAAACC
GCAAACAGGATCACCACTT->CAAACAGGATCACCACTTT
GCAAACTTCTGTATGTTCC->CAAACTTCTGTATGTTCCG
GCAAATGGCTGATTACGAA->CAAATGGCTGATTACGAAA
GCAACAATGTGCCCTCCCC->CAACAATGTGCCCTCCCCA
GCAAGTATTCCAGTAATAG->CAAGTATTCCAGTAATAGT
GCAAGTTATCTTCATCATG->CAAGTTATCTTCATCATGA
GCACAAATCTTGTCGCTAG->CACAAATCTTGTCGCTAGA
GCACACCGCAGCTAGATGA->CACACCGCAGCTAGATGAT
GCACACGCAAGTATTCCAG->CACACGCAAGTATTCCAGT
GCACATGCGTACCCACAAA->CACATGCGTACCCACAAAA
GCACCCTTATAAGACAACC->CACCCTTATAAGACAACCT
GCACCTACTCTTTGTCTCT->CACCTACTCTTTGTCTCTG
GCACGAAAGGTGTTCCAAA->CACGAAAGGTGTTCCAAAT
GCACGCGGTACACACCTGG->CACGCGGTACACACCTGGA
GCACGCTTTGCGGGCTAGC->CACGCTTTGCGGGCTAGCC
GCACTCTGGGAAATATTCC->CACTCTGGGAAATATTCCT
GCAGAACCTCTGATCGGAC->CAGAACCTCTGATCGGACA
GCAGCAGAACCTCTGATCG->CAGCAGAACCTCTGATCGG
GCAGCAGGTGTACTAGTTC->CAGCAGGTGTACTAGTTCG
GCAGCTAGATGATTATCCC->CAGCTAGATGATTATCCCA
GCAGGACCATGCAAATGGC->CAGGACCATGCAAATGGCT
GCAGGATCTTTACGGAGGG->CAGGATCTTTACGGAGGGA
GCAGGTGTACTAGTTCGAA->CAGGTGTACTAGTTCGAAT
GCAGTCTACTAACAGATAT->CAGTCTACTAACAGATATT
GCAGTGAATTCAGAACGCT->CAGTGAATTCAGAACGCTC
GCAGTGCGTCGTCTGGCCC->CAGTGCGTCGTCTGGCCCA
GCATAAATCAAATGGACTA->CATAAATCAAATGGACTAT
GCATACCGGAAACTGCTAA->CATACCGGAAACTGCTAAA
GCATCGCACGCGGTACACA->CATCGCACGCGGTACACAC
GCATGACAATTGGAGTGCG->CATGACAATTGGAGTGCGC
GCATTAGGTGCTAATCGTA->CATTAGGTGCTAATCGTAC
GCATTGATGCAGTGCGTCG->CATTGATGCAGTGCGTCGT
GCATTGATTCTGCATTTAT->CATTGATTCTGCATTTATG
GCATTGTACAGTTATGGCC->CATTGTACAGTTATGGCCT
GCATTTATGATAACGAGAA->CATTTATGATAACGAGAAA
GCATTTTTTGACGAATCCA->CATTTTTTGACGAATCCAT
GCCACCCCTTCAAACCCAT->CCACCCCTTCAAACCCATT
GCCATAGCAACAATGTGCC->CCATAGCAACAATGTGCCC
GCCCACGCGAGGACGGGTT->CCCACGCGAGGACGGGTTG
GCCCAGTATAATCACCTAA->CCCAGTATAATCACCTAAG
GCCCCACGAAGACCAGGAT->CCCCACGAAGACCAGGATA
GCCCCAGACGTAGGTTAGT->CCCCAGACGTAGGTTAGTG
GCCCCTTCACTCGTGGGTG->CCCCTTCACTCGTGGGTGG
GCCCGACTCAACACACAAA->CCCGACTCAACACACAAAA
GCCCGATTGATGTATGGTC->CCCGATTGATGTATGGTCA
GCCCGCTCGCTAGGCAGCA->CCCGCTCGCTAGGCAGCAG
GCCCTAAAAGGCCCCACGA->CCCTAAAAGGCCCCACGAA
GCCCTCCCCACCTTGCACG->CCCTCCCCACCTTGCACGA
GCCCTGGGGTTGCACAAAT->CCCTGGGGTTGCACAAATC
GCCCTGGTATCGTAATCCG->CCCTGGTATCGTAATCCGC
GCCGACCTAGTACGGCTAT->CCGACCTAGTACGGCTATT
GCCGAGCTATTAGTCTTCC->CCGAGCTATTAGTCTTCCT
GCCGAGTTATATGTCCGTG->CCGAGTTATATGTCCGTGC
GCCGATCTGAATCCCAGCT->CCGATCTGAATCCCAGCTC
GCCGCCCTGGTATCGTAAT->CCGCCCTGGTATCGTAATC
GCCGGCGGATAACCAAACT->CCGGCGGATAACCAAACTC
GCCGGCTTCTTCGCGCGCT->CCGGCTTCTTCGCGCGCTC
GCCTAAGGCGGTTTGAAGA->CCTAAGGCGGTTTGAAGAT
GCCTACGGATCCACAACTC->CCTACGGATCCACAACTCC
GCCTAGAACTGCCGAGTTA->CCTAGAACTGCCGAGTTAT
GCCTAGCGGCCGGCGGATA->CCTAGCGGCCGGCGGATAA
GCCTCGCGTTCCTGCTTCA->CCTCGCGTTCCTGCTTCAG
GCCTCGGCTAACTAGCTCC->CCTCGGCTAACTAGCTCCC
GCCTGCATACCGGAAACTG->CCTGCATACCGGAAACTGC
GCCTGGAGCTAAGCTTGTG->CCTGGAGCTAAGCTTGTGT
GCCTGTGTATGGACCTAAG->CCTGTGTATGGACCTAAGC
GCCTTCAGCCTGCATACCG->CCTTCAGCCTGCATACCGG
GCGAACAATGACGAGCACC->CGAACAATGACGAGCACCT
GCGACAGATGACGCTGCTC->CGACAGATGACGCTGCTCG
GCGAGGACGGGTTGGTGGC->CGAGGACGGGTTGGTGGCA
GCGATCTGTAATAGTCGGT->CGATCTGTAATAGTCGGTC
GCGCAAAATTATTCACAAA->CGCAAAATTATTCACAAAA
GCGCACACGCAAGTATTCC->CGCACACGCAAGTATTCCA
GCGCCACCCCTTCAAACCC->CGCCACCCCTTCAAACCCA
GCGCCATAGCAACAATGTG->CGCCATAGCAACAATGTGC
GCGCGAACAATGACGAGCA->CGCGAACAATGACGAGCAC
GCGCGCTCCCGACGACGCA->CGCGCTCCCGACGACGCAG
GCGCGGACTAGGCGCGTTA->CGCGGACTAGGCGCGTTAG
GCGCGTTAGGGGCGTCGTC->CGCGTTAGGGGCGTCGTCG
GCGCTCCCGACGACGCAGG->CGCTCCCGACGACGCAGGA
GCGCTTCTATTACGGACGT->CGCTTCTATTACGGACGTT
GCGGAAACCCCATTTAACG->CGGAAACCCCATTTAACGG
GCGGACTAGGCGCGTTAGG->CGGACTAGGCGCGTTAGGG
GCGGATAACCAAACTCCGT->CGGATAACCAAACTCCGTC
GCGGCCGGCGGATAACCAA->CGGCCGGCGGATAACCAAA
GCGGGAACGCTATGACTGG->CGGGAACGCTATGACTGGA
GCGGGATTTCGCAGTGAAT->CGGGATTTCGCAGTGAATT
GCGGGCTAGCCTCGCGTTC->CGGGCTAGCCTCGCGTTCC
GCGGGTCACCAGAAATTCG->CGGGTCACCAGAAATTCGC
GCGGGTGTGAAAGATCTAC->CGGGTGTGAAAGATCTACG
GCGGTACACACCTGGAGGC->CGGTACACACCTGGAGGCT
GCGGTCGTAAAGGGAGAGG->CGGTCGTAAAGGGAGAGGC
GCGGTTTGAAGATCCAAAC->CGGTTTGAAGATCCAAACA
GCGTACCCACAAAACCCGC->CGTACCCACAAAACCCGCG
GCGTCCGGCCCGATTGATG->CGTCCGGCCCGATTGATGT
GCGTCCGGCGTTGTCGGAA->CGTCCGGCGTTGTCGGAAC
GCGTCCGGCTAGTTCTATC->CGTCCGGCTAGTTCTATCC
GCGTCCGGCTCTATCCAGC->CGTCCGGCTCTATCCAGCG
GCGTCGTCGCGTCGTTAGC->CGTCGTCGCGTCGTTAGCC
GCGTCGTCTGGCCCACGCG->CGTCGTCTGGCCCACGCGA
GCGTCGTTAGCCTTCAGCC->CGTCGTTAGCCTTCAGCCT
GCGTTAGGGGCGTCGTCGC->CGTTAGGGGCGTCGTCGCG
GCGTTCCTGCTTCAGGTAC->CGTTCCTGCTTCAGGTACC
GCGTTGTCGGAACTATAGC->CGTTGTCGGAACTATAGCT
GCTAAATGCAGGACCATGC->CTAAATGCAGGACCATGCA
GCTAACTAGCTCCCCGCCC->CTAACTAGCTCCCCGCCCC
GCTAAGATGACGCCTAGAA->CTAAGATGACGCCTAGAAC
GCTAAGCTTGTGTTAGCAC->CTAAGCTTGTGTTAGCACG
GCTAATCGTACAGCTACAC->CTAATCGTACAGCTACACC
GCTACACCTTCAGGTCACT->CTACACCTTCAGGTCACTG
GCTACAGAACGATCACAAA->CTACAGAACGATCACAAAA
GCTACCCGATTAACGCGCG->CTACCCGATTAACGCGCGA
GCTAGACTGGATTTGCACA->CTAGACTGGATTTGCACAC
GCTAGATGATTATCCCACG->CTAGATGATTATCCCACGC
GCTAGCCTCGCGTTCCTGC->CTAGCCTCGCGTTCCTGCT
GCTAGGCAGCAGGTGTACT->CTAGGCAGCAGGTGTACTA
GCTAGGCCTGGAGCTAAGC->CTAGGCCTGGAGCTAAGCT
GCTAGTTCTATCCGATTCG->CTAGTTCTATCCGATTCGG
GCTATGACTGGAGGAGAGC->CTATGACTGGAGGAGAGCA
GCTATTAGTCTTCCTTATC->CTATTAGTCTTCCTTATCG
GCTATTATTCTGAAATTTG->CTATTATTCTGAAATTTGC
GCTCACTTTAAGTCAGATG->CTCACTTTAAGTCAGATGC
GCTCATTTTATCTAAAAGC->CTCATTTTATCTAAAAGCT
GCTCCCCGCCCCTTCACTC->CTCCCCGCCCCTTCACTCG
GCTCCCGACGACGCAGGAT->CTCCCGACGACGCAGGATC
GCTCCCTGTCCCTAGGCAC->CTCCCTGTCCCTAGGCACA
GCTCCCTGTCCCTAGGCCC->CTCCCTGTCCCTAGGCCCG
GCTCCCTGTCCCTAGGCGC->CTCCCTGTCCCTAGGCGCA
GCTCCCTGTCCCTAGGCTA->CTCCCTGTCCCTAGGCTAC
GCTCGAGAGAATGCATTGA->CTCGAGAGAATGCATTGAT
GCTCGCTAGGCAGCAGGTG->CTCGCTAGGCAGCAGGTGT
GCTCGGACCACAGTGACAT->CTCGGACCACAGTGACATG
GCTCTACTGGTAATTAGAT->CTCTACTGGTAATTAGATA
GCTCTATCCAGCGGGTGTG->CTCTATCCAGCGGGTGTGA
GCTCTCGCCTGTGTATGGA->CTCTCGCCTGTGTATGGAC
GCTGACCGCGCCTGCACCA->CTGACCGCGCCTGCACCAG
GCTGAGCGATCTGTAATAG->CTGAGCGATCTGTAATAGT
GCTGATTACGAAACCAGAG->CTGATTACGAAACCAGAGA
GCTGCTCGAGAGAATGCAT->CTGCTCGAGAGAATGCATT
GCTGCTCTCGCCTGTGTAT->CTGCTCTCGCCTGTGTATG
GCTGTCTCGCCTAGCGGCC->CTGTCTCGCCTAGCGGCCG
GCTTAGTAAAATCCCCTAG->CTTAGTAAAATCCCCTAGG
GCTTCAGGTACCAATTTTT->CTTCAGGTACCAATTTTTA
GCTTCTAAAAGTCTAACAG->CTTCTAAAAGTCTAACAGA
GCTTCTATTACGGACGTTG->CTTCTATTACGGACGTTGG
GCTTCTTCGCGCGCTCCCG->CTTCTTCGCGCGCTCCCGA
GCTTGTGTTAGCACGCTTT->CTTGTGTTAGCACGCTTTG
GCTTTGCGGGCTAGCCTCG->CTTTGCGGGCTAGCCTCGC
GGAAACCCCATTTAACGGC->GAAACCCCATTTAACGGCT
GGAAACTGCTAAATGCAGG->GAAACTGCTAAATGCAGGA
GGAAATATTCCTCCAACGA->GAAATATTCCTCCAACGAA
GGAAATTCTAGGAGCTCCC->GAAATTCTAGGAGCTCCCT
GGAACAGGAAATTCTAGGA->GAACAGGAAATTCTAGGAG
GGAACGCACTCTGGGAAAT->GAACGCACTCTGGGAAATA
GGAACGCTATGACTGGAGG->GAACGCTATGACTGGAGGA
GGAACGGTGTGGGACGTTT->GAACGGTGTGGGACGTTTT
GGAACTATAGCTTCTAAAA->GAACTATAGCTTCTAAAAG
GGAAGGGGACGCATGACAA->GAAGGGGACGCATGACAAT
GGAATGATCAAGCTCACTT->GAATGATCAAGCTCACTTT
GGACACTCGGCGGGAACGC->GACACTCGGCGGGAACGCT
GGACCACAGTGACATGAAT->GACCACAGTGACATGAATT
GGACCATGCAAATGGCTGA->GACCATGCAAATGGCTGAT
GGACCTAAGCTCCCTGTCC->GACCTAAGCTCCCTGTCCC
GGACGACGAGGTATAAAGT->GACGACGAGGTATAAAGTT
GGACGCATGACAATTGGAG->GACGCATGACAATTGGAGT
GGACGGGTTGGTGGCATCG->GACGGGTTGGTGGCATCGC
GGACGTTGGCATTAGGTGC->GACGTTGGCATTAGGTGCT
GGACGTTTTGTGAGGGGGC->GACGTTTTGTGAGGGGGCC
GGACTAGGCGCGTTAGGGG->GACTAGGCGCGTTAGGGGC
GGACTATAAGAATATTCCT->GACTATAAGAATATTCCTG
GGAGAGAGTATACTGGTGA->GAGAGAGTATACTGGTGAT
GGAGAGCATTGTACAGTTA->GAGAGCATTGTACAGTTAT
GGAGAGGCTCGGACCACAG->GAGAGGCTCGGACCACAGT
GGAGCTAAGCTTGTGTTAG->GAGCTAAGCTTGTGTTAGC
GGAGCTCCCTGTCCCTAGG->GAGCTCCCTGTCCCTAGGC
GGAGGAGAGCATTGTACAG->GAGGAGAGCATTGTACAGT
GGAGGCAAACTTCTGTATG->GAGGCAAACTTCTGTATGT
GGAGGCTAGGCCTGGAGCT->GAGGCTAGGCCTGGAGCTA
GGAGGGAACGCACTCTGGG->GAGGGAACGCACTCTGGGA
GGAGTGCGCTTCTATTACG->GAGTGCGCTTCTATTACGG
GGATAACCAAACTCCGTCA->GATAACCAAACTCCGTCAT
GGATACGCCTACGGATCCA->GATACGCCTACGGATCCAC
GGATCACCACTTTCCATGA->GATCACCACTTTCCATGAA
GGATCCACAACTCCTGCTA->GATCCACAACTCCTGCTAA
GGATCTTTACGGAGGGAAC->GATCTTTACGGAGGGAACG
GGATGACTTCATCTTAGCC->GATGACTTCATCTTAGCCG
GGATGTGTAGATATTGTCA->GATGTGTAGATATTGTCAA
GGATTGGCGCGGACTAGGC->GATTGGCGCGGACTAGGCG
GGATTGGGGGGAACAGGAA->GATTGGGGGGAACAGGAAA
GGATTTCGCAGTGAATTCA->GATTTCGCAGTGAATTCAG
GGATTTGCACACCGCAGCT->GATTTGCACACCGCAGCTA
GGCAAACTTCTGTATGTTC->GCAAACTTCTGTATGTTCC
GGCAAGTTATCTTCATCAT->GCAAGTTATCTTCATCATG
GGCACATGCGTACCCACAA->GCACATGCGTACCCACAAA
GGCACCCTTATAAGACAAC->GCACCCTTATAAGACAACC
GGCAGCAGGTGTACTAGTT->GCAGCAGGTGTACTAGTTC
GGCATCGCACGCGGTACAC->GCATCGCACGCGGTACACA
GGCATTAGGTGCTAATCGT->GCATTAGGTGCTAATCGTA
GGCCCACGCGAGGACGGGT->GCCCACGCGAGGACGGGTT
GGCCCCACGAAGACCAGGA->GCCCCACGAAGACCAGGAT
GGCCCGACTCAACACACAA->GCCCGACTCAACACACAAA
GGCCCGATTGATGTATGGT->GCCCGATTGATGTATGGTC
GGCCCTAAAAGGCCCCACG->GCCCTAAAAGGCCCCACGA
GGCCCTGGGGTTGCACAAA->GCCCTGGGGTTGCACAAAT
GGCCGATCTGAATCCCAGC->GCCGATCTGAATCCCAGCT
GGCCGCCCTGGTATCGTAA->GCCGCCCTGGTATCGTAAT
GGCCGGCGGATAACCAAAC->GCCGGCGGATAACCAAACT
GGCCTAAGGCGGTTTGAAG->GCCTAAGGCGGTTTGAAGA
GGCCTGGAGCTAAGCTTGT->GCCTGGAGCTAAGCTTGTG
GGCGCAAAATTATTCACAA->GCGCAAAATTATTCACAAA
GGCGCACACGCAAGTATTC->GCGCACACGCAAGTATTCC
GGCGCGGACTAGGCGCGTT->GCGCGGACTAGGCGCGTTA
GGCGCGTTAGGGGCGTCGT->GCGCGTTAGGGGCGTCGTC
GGCGGATAACCAAACTCCG->GCGGATAACCAAACTCCGT
GGCGGGAACGCTATGACTG->GCGGGAACGCTATGACTGG
GGCGGTTTGAAGATCCAAA->GCGGTTTGAAGATCCAAAC
GGCGTCGTCGCGTCGTTAG->GCGTCGTCGCGTCGTTAGC
GGCGTTGTCGGAACTATAG->GCGTTGTCGGAACTATAGC
GGCTAACTAGCTCCCCGCC->GCTAACTAGCTCCCCGCCC
GGCTACAGAACGATCACAA->GCTACAGAACGATCACAAA
GGCTAGCCTCGCGTTCCTG->GCTAGCCTCGCGTTCCTGC
GGCTAGGCCTGGAGCTAAG->GCTAGGCCTGGAGCTAAGC
GGCTAGTTCTATCCGATTC->GCTAGTTCTATCCGATTCG
GGCTATTATTCTGAAATTT->GCTATTATTCTGAAATTTG
GGCTCGGACCACAGTGACA->GCTCGGACCACAGTGACAT
GGCTCTATCCAGCGGGTGT->GCTCTATCCAGCGGGTGTG
GGCTGATTACGAAACCAGA->GCTGATTACGAAACCAGAG
GGCTGTCTCGCCTAGCGGC->GCTGTCTCGCCTAGCGGCC
GGCTTAGTAAAATCCCCTA->GCTTAGTAAAATCCCCTAG
GGCTTCTTCGCGCGCTCCC->GCTTCTTCGCGCGCTCCCG
GGGAAATATTCCTCCAACG->GGAAATATTCCTCCAACGA
GGGAACAGGAAATTCTAGG->GGAACAGGAAATTCTAGGA
GGGAACGCACTCTGGGAAA->GGAACGCACTCTGGGAAAT
GGGAACGCTATGACTGGAG->GGAACGCTATGACTGGAGG
GGGAATGATCAAGCTCACT->GGAATGATCAAGCTCACTT
GGGACGCATGACAATTGGA->GGACGCATGACAATTGGAG
GGGACGTTTTGTGAGGGGG->GGACGTTTTGTGAGGGGGC
GGGAGAGGCTCGGACCACA->GGAGAGGCTCGGACCACAG
GGGATGTGTAGATATTGTC->GGATGTGTAGATATTGTCA
GGGATTTCGCAGTGAATTC->GGATTTCGCAGTGAATTCA
GGGCCCTAAAAGGCCCCAC->GGCCCTAAAAGGCCCCACG
GGGCCCTGGGGTTGCACAA->GGCCCTGGGGTTGCACAAA
GGGCCGATCTGAATCCCAG->GGCCGATCTGAATCCCAGC
GGGCGCACACGCAAGTATT->GGCGCACACGCAAGTATTC
GGGCGTCGTCGCGTCGTTA->GGCGTCGTCGCGTCGTTAG
GGGCTAGCCTCGCGTTCCT->GGCTAGCCTCGCGTTCCTG
GGGGAACAGGAAATTCTAG->GGGAACAGGAAATTCTAGG
GGGGACGCATGACAATTGG->GGGACGCATGACAATTGGA
GGGGCCCTGGGGTTGCACA->GGGCCCTGGGGTTGCACAA
GGGGCGTCGTCGCGTCGTT->GGGCGTCGTCGCGTCGTTA
GGGGGAACAGGAAATTCTA->GGGGAACAGGAAATTCTAG
GGGGGCCCTGGGGTTGCAC->GGGGCCCTGGGGTTGCACA
GGGGGGAACAGGAAATTCT->GGGGGAACAGGAAATTCTA
GGGGTTGCACAAATCTTGT->GGGTTGCACAAATCTTGTC
GGGTCACCAGAAATTCGCC->GGTCACCAGAAATTCGCCG
GGGTGGTGGGCCGATCTGA->GGTGGTGGGCCGATCTGAA
GGGTGTGAAAGATCTACGC->GGTGTGAAAGATCTACGCA
GGGTTGCACAAATCTTGTC->GGTTGCACAAATCTTGTCG
GGGTTGGTGGCATCGCACG->GGTTGGTGGCATCGCACGC
GGTAATTAGATATACCTAC->GTAATTAGATATACCTACG
GGTACACACCTGGAGGCTA->GTACACACCTGGAGGCTAG
GGTACCAATTTTTACGTCG->GTACCAATTTTTACGTCGC
GGTACTAGCTCCCTGTCCC->GTACTAGCTCCCTGTCCCT
GGTATAAAGTTTTTTAGGT->GTATAAAGTTTTTTAGGTT
GGTATCGTAATCCGCGACA->GTATCGTAATCCGCGACAG
GGTCACCAGAAATTCGCCG->GTCACCAGAAATTCGCCGA
GGTCACTGCGCCATAGCAA->GTCACTGCGCCATAGCAAC
GGTCAGAACAGGAAGGGGA->GTCAGAACAGGAAGGGGAC
GGTCGGCAAGTTATCTTCA->GTCGGCAAGTTATCTTCAT
GGTCGTAAAGGGAGAGGCT->GTCGTAAAGGGAGAGGCTC
GGTCTCGCGGGATTTCGCA->GTCTCGCGGGATTTCGCAG
GGTGATCAACCAACCATCT->GTGATCAACCAACCATCTT
GGTGCTAATCGTACAGCTA->GTGCTAATCGTACAGCTAC
GGTGGCATCGCACGCGGTA->GTGGCATCGCACGCGGTAC
GGTGGGCCGATCTGAATCC->GTGGGCCGATCTGAATCCC
GGTGGTGGGCCGATCTGAA->GTGGTGGGCCGATCTGAAT
GGTGTACTAGTTCGAATAA->GTGTACTAGTTCGAATAAA
GGTGTGAAAGATCTACGCA->GTGTGAAAGATCTACGCAG
GGTGTGGGACGTTTTGTGA->GTGTGGGACGTTTTGTGAG
GGTGTTCCAAATTCCATGG->GTGTTCCAAATTCCATGGG
GGTTAGTGCTGACCGCGCC->GTTAGTGCTGACCGCGCCT
GGTTCCTGGCTTAGTAAAA->GTTCCTGGCTTAGTAAAAT
GGTTGCACAAATCTTGTCG->GTTGCACAAATCTTGTCGC
GGTTGGTGGCATCGCACGC->GTTGGTGGCATCGCACGCG
GGTTTGAAGATCCAAACAC->GTTTGAAGATCCAAACACT
GTAAAATCCCCTAGGCCGC->TAAAATCCCCTAGGCCGCC
GTAAAGGGAGAGGCTCGGA->TAAAGGGAGAGGCTCGGAC
GTAAGCGGTCGTAAAGGGA->TAAGCGGTCGTAAAGGGAG
GTAATAGTCGGTCGGCAAG->TAATAGTCGGTCGGCAAGT
GTAATAGTGCGGAAACCCC->TAATAGTGCGGAAACCCCA
GTAATCCGCGACAGATGAC->TAATCCGCGACAGATGACG
GTAATTAGATATACCTACG->TAATTAGATATACCTACGG
GTACACACCTGGAGGCTAG->TACACACCTGGAGGCTAGG
GTACAGCTACACCTTCAGG->TACAGCTACACCTTCAGGT
GTACAGTTATGGCCTAAGG->TACAGTTATGGCCTAAGGC
GTACCAATTTTTACGTCGC->TACCAATTTTTACGTCGCA
GTACCCACAAAACCCGCGT->TACCCACAAAACCCGCGTC
GTACGACCGCAGCAGAACC->TACGACCGCAGCAGAACCT
GTACGGCTATTATTCTGAA->TACGGCTATTATTCTGAAA
GTACTAGCTCCCTGTCCCT->TACTAGCTCCCTGTCCCTA
GTACTAGTTCGAATAAAAG->TACTAGTTCGAATAAAAGC
GTAGATATTGTCAAAGCTG->TAGATATTGTCAAAGCTGA
GTAGGTTAGTGCTGACCGC->TAGGTTAGTGCTGACCGCG
GTATAAAGTTTTTTAGGTT->TATAAAGTTTTTTAGGTTC
GTATAATCACCTAAGAAGG->TATAATCACCTAAGAAGGA
GTATACTGGTGATCAACCA->TATACTGGTGATCAACCAA
GTATCGTAATCCGCGACAG->TATCGTAATCCGCGACAGA
GTATGGACCTAAGCTCCCT->TATGGACCTAAGCTCCCTG
GTATGGTCAGAACAGGAAG->TATGGTCAGAACAGGAAGG
GTATGTTCCGCGCCACCCC->TATGTTCCGCGCCACCCCT
GTATTCCAGTAATAGTGCG->TATTCCAGTAATAGTGCGG
GTCAAAGCTGAGCGATCTG->TCAAAGCTGAGCGATCTGT
GTCACCAGAAATTCGCCGA->TCACCAGAAATTCGCCGAC
GTCACTGCGCCATAGCAAC->TCACTGCGCCATAGCAACA
GTCAGAAAGTCCGAATAGG->TCAGAAAGTCCGAATAGGG
GTCAGAACAGGAAGGGGAC->TCAGAACAGGAAGGGGACG
GTCAGATGCCGGCTTCTTC->TCAGATGCCGGCTTCTTCG
GTCATGCATAAATCAAATG->TCATGCATAAATCAAATGG
GTCCCTAGGCACATGCGTA->TCCCTAGGCACATGCGTAC
GTCCCTAGGCCCGACTCAA->TCCCTAGGCCCGACTCAAC
GTCCCTAGGCGCAAAATTA->TCCCTAGGCGCAAAATTAT
GTCCCTAGGCTACAGAACG->TCCCTAGGCTACAGAACGA
GTCCGAATAGGGCGCACAC->TCCGAATAGGGCGCACACG
GTCCGGCCCGATTGATGTA->TCCGGCCCGATTGATGTAT
GTCCGGCGTTGTCGGAACT->TCCGGCGTTGTCGGAACTA
GTCCGGCTAGTTCTATCCG->TCCGGCTAGTTCTATCCGA
GTCCGGCTCTATCCAGCGG->TCCGGCTCTATCCAGCGGG
GTCCGTGCAAACAGGATCA->TCCGTGCAAACAGGATCAC
GTCGCATTGATTCTGCATT->TCGCATTGATTCTGCATTT
GTCGCGTCGTTAGCCTTCA->TCGCGTCGTTAGCCTTCAG
GTCGCTAGACTGGATTTGC->TCGCTAGACTGGATTTGCA
GTCGGAACTATAGCTTCTA->TCGGAACTATAGCTTCTAA
GTCGGCAAGTTATCTTCAT->TCGGCAAGTTATCTTCATC
GTCGGTCGGCAAGTTATCT->TCGGTCGGCAAGTTATCTT
GTCGTAAAGGGAGAGGCTC->TCGTAAAGGGAGAGGCTCG
GTCGTCGCGTCGTTAGCCT->TCGTCGCGTCGTTAGCCTT
GTCGTCTGGCCCACGCGAG->TCGTCTGGCCCACGCGAGG
GTCGTTAGCCTTCAGCCTG->TCGTTAGCCTTCAGCCTGC
GTCTAACAGACTAAGTTGG->TCTAACAGACTAAGTTGGA
GTCTACTAACAGATATTGA->TCTACTAACAGATATTGAC
GTCTCGCCTAGCGGCCGGC->TCTCGCCTAGCGGCCGGCG
GTCTCGCGGGATTTCGCAG->TCTCGCGGGATTTCGCAGT
GTCTCTGGGAATGATCAAG->TCTCTGGGAATGATCAAGC
GTCTGGCCCACGCGAGGAC->TCTGGCCCACGCGAGGACG
GTCTTCCTTATCGCGGGTC->TCTTCCTTATCGCGGGTCA
GTGAAAGATCTACGCAGTC->TGAAAGATCTACGCAGTCT
GTGAATTCAGAACGCTCAT->TGAATTCAGAACGCTCATT
GTGACATGAATTACACAGA->TGACATGAATTACACAGAT
GTGACGCCCCAGACGTAGG->TGACGCCCCAGACGTAGGT
GTGAGGGGGCCCTGGGGTT->TGAGGGGGCCCTGGGGTTG
GTGATCAACCAACCATCTT->TGATCAACCAACCATCTTA
GTGCAAACAGGATCACCAC->TGCAAACAGGATCACCACT
GTGCCCTCCCCACCTTGCA->TGCCCTCCCCACCTTGCAC
GTGCGCTTCTATTACGGAC->TGCGCTTCTATTACGGACG
GTGCGGAAACCCCATTTAA->TGCGGAAACCCCATTTAAC
GTGCGTCGTCTGGCCCACG->TGCGTCGTCTGGCCCACGC
GTGCTAATCGTACAGCTAC->TGCTAATCGTACAGCTACA
GTGCTGACCGCGCCTGCAC->TGCTGACCGCGCCTGCACC
GTGGAGAGAGTATACTGGT->TGGAGAGAGTATACTGGTG
GTGGATGACTTCATCTTAG->TGGATGACTTCATCTTAGC
GTGGCACCCTTATAAGACA->TGGCACCCTTATAAGACAA
GTGGCATCGCACGCGGTAC->TGGCATCGCACGCGGTACA
GTGGGACGTTTTGTGAGGG->TGGGACGTTTTGTGAGGGG
GTGGGCCGATCTGAATCCC->TGGGCCGATCTGAATCCCA
GTGGGTGGTGGGCCGATCT->TGGGTGGTGGGCCGATCTG
GTGGTGGGCCGATCTGAAT->TGGTGGGCCGATCTGAATC
GTGTACTAGTTCGAATAAA->TGTACTAGTTCGAATAAAA
GTGTAGATATTGTCAAAGC->TGTAGATATTGTCAAAGCT
GTGTATGGACCTAAGCTCC->TGTATGGACCTAAGCTCCC
GTGTGAAAGATCTACGCAG->TGTGAAAGATCTACGCAGT
GTGTGGCACCCTTATAAGA->TGTGGCACCCTTATAAGAC
GTGTGGGACGTTTTGTGAG->TGTGGGACGTTTTGTGAGG
GTGTTAGCACGCTTTGCGG->TGTTAGCACGCTTTGCGGG
GTGTTCCAAATTCCATGGG->TGTTCCAAATTCCATGGGA
GTTACTTAATCCGCCCAGT->TTACTTAATCCGCCCAGTA
GTTAGCACGCTTTGCGGGC->TTAGCACGCTTTGCGGGCT
GTTAGCCTTCAGCCTGCAT->TTAGCCTTCAGCCTGCATA
GTTAGGGGCGTCGTCGCGT->TTAGGGGCGTCGTCGCGTC
GTTAGTGCTGACCGCGCCT->TTAGTGCTGACCGCGCCTG
GTTATATGTCCGTGCAAAC->TTATATGTCCGTGCAAACA
GTTATCTTCATCATGATCT->TTATCTTCATCATGATCTT
GTTATGGCCTAAGGCGGTT->TTATGGCCTAAGGCGGTTT
GTTCCAAATTCCATGGGAT->TTCCAAATTCCATGGGATG
GTTCCGCGCCACCCCTTCA->TTCCGCGCCACCCCTTCAA
GTTCCTGCTTCAGGTACCA->TTCCTGCTTCAGGTACCAA
GTTCCTGGCTTAGTAAAAT->TTCCTGGCTTAGTAAAATC
GTTCGAATAAAAGCCTCGG->TTCGAATAAAAGCCTCGGC
GTTCTATCCGATTCGGATT->TTCTATCCGATTCGGATTG
GTTGCACAAATCTTGTCGC->TTGCACAAATCTTGTCGCT
GTTGGATTGGGGGGAACAG->TTGGATTGGGGGGAACAGG
GTTGGCATTAGGTGCTAAT->TTGGCATTAGGTGCTAATC
GTTGGTGGCATCGCACGCG->TTGGTGGCATCGCACGCGG
GTTGTCGGAACTATAGCTT->TTGTCGGAACTATAGCTTC
GTTTGAAGATCCAAACACT->TTTGAAGATCCAAACACTT
GTTTTGTGAGGGGGCCCTG->TTTTGTGAGGGGGCCCTGG
GTTTTTTAGGTTCCTGGCT->TTTTTTAGGTTCCTGGCTT
TAAAACGGTCTCGCGGGAT->AAAACGGTCTCGCGGGATT
TAAAAGCCTCGGCTAACTA->AAAAGCCTCGGCTAACTAG
TAAAAGCTCTACTGGTAAT->AAAAGCTCTACTGGTAATT
TAAAAGGCCCCACGAAGAC->AAAAGGCCCCACGAAGACC
TAAAAGTCTAACAGACTAA->AAAAGTCTAACAGACTAAG
TAAAATCCCCTAGGCCGCC->AAAATCCCCTAGGCCGCCC
TAAAGGGAGAGGCTCGGAC->AAAGGGAGAGGCTCGGACC
TAAAGTTTTTTAGGTTCCT->AAAGTTTTTTAGGTTCCTG
TAAATCAAATGGACTATAA->AAATCAAATGGACTATAAG
TAAATGCAGGACCATGCAA->AAATGCAGGACCATGCAAA
TAACAGACTAAGTTGGATT->AACAGACTAAGTTGGATTG
TAACAGATATTGACCGGAC->AACAGATATTGACCGGACG
TAACCAAACTCCGTCATGC->AACCAAACTCCGTCATGCA
TAACGAGAAAGTGACGCCC->AACGAGAAAGTGACGCCCC
TAACGCGCGAACAATGACG->AACGCGCGAACAATGACGA
TAACGGCTGTCTCGCCTAG->AACGGCTGTCTCGCCTAGC
TAACTAGCTCCCCGCCCCT->AACTAGCTCCCCGCCCCTT
TAACTGTGGATGACTTCAT->AACTGTGGATGACTTCATC
TAAGAAGGAGGCAAACTTC->AAGAAGGAGGCAAACTTCT
TAAGAATATTCCTGAGTGT->AAGAATATTCCTGAGTGTG
TAAGACAACCTATGTTACT->AAGACAACCTATGTTACTT
TAAGATGACGCCTAGAACT->AAGATGACGCCTAGAACTG
TAAGCGGTCGTAAAGGGAG->AAGCGGTCGTAAAGGGAGA
TAAGCTCCCTGTCCCTAGG->AAGCTCCCTGTCCCTAGGC
TAAGCTTGTGTTAGCACGC->AAGCTTGTGTTAGCACGCT
TAAGGCGGTTTGAAGATCC->AAGGCGGTTTGAAGATCCA
TAAGTCAGATGCCGGCTTC->AAGTCAGATGCCGGCTTCT
TAAGTTGGATTGGGGGGAA->AAGTTGGATTGGGGGGAAC
TAATAGTCGGTCGGCAAGT->AATAGTCGGTCGGCAAGTT
TAATAGTGCGGAAACCCCA->AATAGTGCGGAAACCCCAT
TAATCACCTAAGAAGGAGG->AATCACCTAAGAAGGAGGC
TAATCCGCCCAGTATAATC->AATCCGCCCAGTATAATCA
TAATCCGCGACAGATGACG->AATCCGCGACAGATGACGC
TAATCGTACAGCTACACCT->AATCGTACAGCTACACCTT
TAATTAGATATACCTACGG->AATTAGATATACCTACGGT
TACACACCTGGAGGCTAGG->ACACACCTGGAGGCTAGGC
TACACAGATATGCTGCTCT->ACACAGATATGCTGCTCTC
TACACCTTCAGGTCACTGC->ACACCTTCAGGTCACTGCG
TACAGAACGATCACAAAAC->ACAGAACGATCACAAAACC
TACAGCTACACCTTCAGGT->ACAGCTACACCTTCAGGTC
TACAGTTATGGCCTAAGGC->ACAGTTATGGCCTAAGGCG
TACCAATTTTTACGTCGCA->ACCAATTTTTACGTCGCAT
TACCCACAAAACCCGCGTC->ACCCACAAAACCCGCGTCC
TACCCGATTAACGCGCGAA->ACCCGATTAACGCGCGAAC
TACCGGAAACTGCTAAATG->ACCGGAAACTGCTAAATGC
TACCTACGGTACTAGCTCC->ACCTACGGTACTAGCTCCC
TACCTTTTCCTTTTTAACT->ACCTTTTCCTTTTTAACTG
TACGAAACCAGAGATCACT->ACGAAACCAGAGATCACTC
TACGAACGTACGACCGCAG->ACGAACGTACGACCGCAGC
TACGACCGCAGCAGAACCT->ACGACCGCAGCAGAACCTC
TACGCAGTCTACTAACAGA->ACGCAGTCTACTAACAGAT
TACGCCTACGGATCCACAA->ACGCCTACGGATCCACAAC
TACGGACGTTGGCATTAGG->ACGGACGTTGGCATTAGGT
TACGGAGGGAACGCACTCT->ACGGAGGGAACGCACTCTG
TACGGATCCACAACTCCTG->ACGGATCCACAACTCCTGC
TACGGCTATTATTCTGAAA->ACGGCTATTATTCTGAAAT
TACGGTACTAGCTCCCTGT->ACGGTACTAGCTCCCTGTC
TACGTCGCATTGATTCTGC->ACGTCGCATTGATTCTGCA
TACTAACAGATATTGACCG->ACTAACAGATATTGACCGG
TACTACCTTTTCCTTTTTA->ACTACCTTTTCCTTTTTAA
TACTAGCTCCCTGTCCCTA->ACTAGCTCCCTGTCCCTAG
TACTAGTTCGAATAAAAGC->ACTAGTTCGAATAAAAGCC
TACTCTTTGTCTCTGGGAA->ACTCTTTGTCTCTGGGAAT
TACTGGTAATTAGATATAC->ACTGGTAATTAGATATACC
TACTGGTGATCAACCAACC->ACTGGTGATCAACCAACCA
TACTTAATCCGCCCAGTAT->ACTTAATCCGCCCAGTATA
TAGAACTGCCGAGTTATAT->AGAACTGCCGAGTTATATG
TAGACTGGATTTGCACACC->AGACTGGATTTGCACACCG
TAGATATACCTACGGTACT->AGATATACCTACGGTACTA
TAGATATTGTCAAAGCTGA->AGATATTGTCAAAGCTGAG
TAGATGATTATCCCACGCA->AGATGATTATCCCACGCAT
TAGCAACAATGTGCCCTCC->AGCAACAATGTGCCCTCCC
TAGCACGCTTTGCGGGCTA->AGCACGCTTTGCGGGCTAG
TAGCCGAGCTATTAGTCTT->AGCCGAGCTATTAGTCTTC
TAGCCTCGCGTTCCTGCTT->AGCCTCGCGTTCCTGCTTC
TAGCCTTCAGCCTGCATAC->AGCCTTCAGCCTGCATACC
TAGCGGCCGGCGGATAACC->AGCGGCCGGCGGATAACCA
TAGCTCCCCGCCCCTTCAC->AGCTCCCCGCCCCTTCACT
TAGCTCCCTGTCCCTAGGC->AGCTCCCTGTCCCTAGGCT
TAGCTTCTAAAAGTCTAAC->AGCTTCTAAAAGTCTAACA
TAGGAGCTCCCTGTCCCTA->AGGAGCTCCCTGTCCCTAG
TAGGCACATGCGTACCCAC->AGGCACATGCGTACCCACA
TAGGCAGCAGGTGTACTAG->AGGCAGCAGGTGTACTAGT
TAGGCCCGACTCAACACAC->AGGCCCGACTCAACACACA
TAGGCCGCCCTGGTATCGT->AGGCCGCCCTGGTATCGTA
TAGGCCTGGAGCTAAGCTT->AGGCCTGGAGCTAAGCTTG
TAGGCGCAAAATTATTCAC->AGGCGCAAAATTATTCACA
TAGGCGCGTTAGGGGCGTC->AGGCGCGTTAGGGGCGTCG
TAGGCTACAGAACGATCAC->AGGCTACAGAACGATCACA
TAGGGCGCACACGCAAGTA->AGGGCGCACACGCAAGTAT
TAGGGGCGTCGTCGCGTCG->AGGGGCGTCGTCGCGTCGT
TAGGTGCTAATCGTACAGC->AGGTGCTAATCGTACAGCT
TAGGTTAGTGCTGACCGCG->AGGTTAGTGCTGACCGCGC
TAGGTTCCTGGCTTAGTAA->AGGTTCCTGGCTTAGTAAA
TAGTAAAATCCCCTAGGCC->AGTAAAATCCCCTAGGCCG
TAGTACGGCTATTATTCTG->AGTACGGCTATTATTCTGA
TAGTCGGTCGGCAAGTTAT->AGTCGGTCGGCAAGTTATC
TAGTCTTCCTTATCGCGGG->AGTCTTCCTTATCGCGGGT
TAGTGCGGAAACCCCATTT->AGTGCGGAAACCCCATTTA
TAGTGCTGACCGCGCCTGC->AGTGCTGACCGCGCCTGCA
TAGTTCGAATAAAAGCCTC->AGTTCGAATAAAAGCCTCG
TAGTTCTATCCGATTCGGA->AGTTCTATCCGATTCGGAT
TATAAAGTTTTTTAGGTTC->ATAAAGTTTTTTAGGTTCC
TATAAGAATATTCCTGAGT->ATAAGAATATTCCTGAGTG
TATAAGACAACCTATGTTA->ATAAGACAACCTATGTTAC
TATAATCACCTAAGAAGGA->ATAATCACCTAAGAAGGAG
TATACCTACGGTACTAGCT->ATACCTACGGTACTAGCTC
TATACTGGTGATCAACCAA->ATACTGGTGATCAACCAAC
TATAGCTTCTAAAAGTCTA->ATAGCTTCTAAAAGTCTAA
TATATGTCCGTGCAAACAG->ATATGTCCGTGCAAACAGG
TATCCAGCGGGTGTGAAAG->ATCCAGCGGGTGTGAAAGA
TATCCCACGCATTTTTTGA->ATCCCACGCATTTTTTGAC
TATCCGATTCGGATTGGCG->ATCCGATTCGGATTGGCGC
TATCGCGGGTCACCAGAAA->ATCGCGGGTCACCAGAAAT
TATCGTAATCCGCGACAGA->ATCGTAATCCGCGACAGAT
TATCTAAAAGCTCTACTGG->ATCTAAAAGCTCTACTGGT
TATCTTCATCATGATCTTT->ATCTTCATCATGATCTTTG
TATGACTGGAGGAGAGCAT->ATGACTGGAGGAGAGCATT
TATGATAACGAGAAAGTGA->ATGATAACGAGAAAGTGAC
TATGCTGCTCTCGCCTGTG->ATGCTGCTCTCGCCTGTGT
TATGGACCTAAGCTCCCTG->ATGGACCTAAGCTCCCTGT
TATGGCCTAAGGCGGTTTG->ATGGCCTAAGGCGGTTTGA
TATGGTCAGAACAGGAAGG->ATGGTCAGAACAGGAAGGG
TATGTCCGTGCAAACAGGA->ATGTCCGTGCAAACAGGAT
TATGTTACTTAATCCGCCC->ATGTTACTTAATCCGCCCA
TATGTTCCGCGCCACCCCT->ATGTTCCGCGCCACCCCTT
TATTACGGACGTTGGCATT->ATTACGGACGTTGGCATTA
TATTAGTCTTCCTTATCGC->ATTAGTCTTCCTTATCGCG
TATTATTCTGAAATTTGCC->ATTATTCTGAAATTTGCCC
TATTCACAAAACCCGCGTC->ATTCACAAAACCCGCGTCC
TATTCCAGTAATAGTGCGG->ATTCCAGTAATAGTGCGGA
TATTCCTCCAACGAACCTG->ATTCCTCCAACGAACCTGT
TATTCCTGAGTGTGGCACC->ATTCCTGAGTGTGGCACCC
TATTCTGAAATTTGCCCGC->ATTCTGAAATTTGCCCGCT
TATTGACCGGACGACGAGG->ATTGACCGGACGACGAGGT
TATTGTCAAAGCTGAGCGA->ATTGTCAAAGCTGAGCGAT
TCAAACCCATTACGAACGT->CAAACCCATTACGAACGTA
TCAAAGCTGAGCGATCTGT->CAAAGCTGAGCGATCTGTA
TCAAATGGACTATAAGAAT->CAAATGGACTATAAGAATA
TCAACACACAAAACCCGCG->CAACACACAAAACCCGCGT
TCAACCAACCATCTTACTA->CAACCAACCATCTTACTAC
TCAAGCTCACTTTAAGTCA->CAAGCTCACTTTAAGTCAG
TCACAAAACCCGCGTCCGG->CACAAAACCCGCGTCCGGC,CACAAAACCCGCGTCCGGC
TCACCACTTTCCATGAACT->CACCACTTTCCATGAACTA
TCACCAGAAATTCGCCGAC->CACCAGAAATTCGCCGACC
TCACCTAAGAAGGAGGCAA->CACCTAAGAAGGAGGCAAA
TCACTCGGGCCCTAAAAGG->CACTCGGGCCCTAAAAGGC
TCACTCGTGGGTGGTGGGC->CACTCGTGGGTGGTGGGCC
TCACTGCGCCATAGCAACA->CACTGCGCCATAGCAACAA
TCACTTTAAGTCAGATGCC->CACTTTAAGTCAGATGCCG
TCAGAAAGTCCGAATAGGG->CAGAAAGTCCGAATAGGGC
TCAGAACAGGAAGGGGACG->CAGAACAGGAAGGGGACGC
TCAGAACGCTCATTTTATC->CAGAACGCTCATTTTATCT
TCAGATGCCGGCTTCTTCG->CAGATGCCGGCTTCTTCGC
TCAGCCTGCATACCGGAAA->CAGCCTGCATACCGGAAAC
TCAGGTACCAATTTTTACG->CAGGTACCAATTTTTACGT
TCAGGTCACTGCGCCATAG->CAGGTCACTGCGCCATAGC
TCATCATGATCTTTGTCAG->CATCATGATCTTTGTCAGA
TCATCTTAGCCGAGCTATT->CATCTTAGCCGAGCTATTA
TCATGATCTTTGTCAGAAA->CATGATCTTTGTCAGAAAG
TCATGCATAAATCAAATGG->CATGCATAAATCAAATGGA
TCATTTTATCTAAAAGCTC->CATTTTATCTAAAAGCTCT
TCCAAACACTTCGGAACGG->CCAAACACTTCGGAACGGT
TCCAAATTCCATGGGATGT->CCAAATTCCATGGGATGTG
TCCAACGAACCTGTGGAGA->CCAACGAACCTGTGGAGAG
TCCACAACTCCTGCTAAGA->CCACAACTCCTGCTAAGAT
TCCAGCGGGTGTGAAAGAT->CCAGCGGGTGTGAAAGATC
TCCAGTAATAGTGCGGAAA->CCAGTAATAGTGCGGAAAC
TCCATGAACTAAAACGGTC->CCATGAACTAAAACGGTCT
TCCATGCTACCCGATTAAC->CCATGCTACCCGATTAACG
TCCATGGGATGTGTAGATA->CCATGGGATGTGTAGATAT
TCCCACGCATTTTTTGACG->CCCACGCATTTTTTGACGA
TCCCAGCTCCCTGTCCCTA->CCCAGCTCCCTGTCCCTAG
TCCCCACCTTGCACGAAAG->CCCCACCTTGCACGAAAGG
TCCCCGCCCCTTCACTCGT->CCCCGCCCCTTCACTCGTG
TCCCCTAGGCCGCCCTGGT->CCCCTAGGCCGCCCTGGTA
TCCCGACGACGCAGGATCT->CCCGACGACGCAGGATCTT
TCCCTAGGCACATGCGTAC->CCCTAGGCACATGCGTACC
TCCCTAGGCCCGACTCAAC->CCCTAGGCCCGACTCAACA
TCCCTAGGCGCAAAATTAT->CCCTAGGCGCAAAATTATT
TCCCTAGGCTACAGAACGA->CCCTAGGCTACAGAACGAT
TCCCTGTCCCTAGGCACAT->CCCTGTCCCTAGGCACATG
TCCCTGTCCCTAGGCCCGA->CCCTGTCCCTAGGCCCGAC
TCCCTGTCCCTAGGCGCAA->CCCTGTCCCTAGGCGCAAA
TCCCTGTCCCTAGGCTACA->CCCTGTCCCTAGGCTACAG
TCCGAATAGGGCGCACACG->CCGAATAGGGCGCACACGC
TCCGATTCGGATTGGCGCG->CCGATTCGGATTGGCGCGG
TCCGCCCAGTATAATCACC->CCGCCCAGTATAATCACCT
TCCGCGACAGATGACGCTG->CCGCGACAGATGACGCTGC
TCCGCGCCACCCCTTCAAA->CCGCGCCACCCCTTCAAAC
TCCGGCCCGATTGATGTAT->CCGGCCCGATTGATGTATG
TCCGGCGTTGTCGGAACTA->CCGGCGTTGTCGGAACTAT
TCCGGCTAGTTCTATCCGA->CCGGCTAGTTCTATCCGAT
TCCGGCTCTATCCAGCGGG->CCGGCTCTATCCAGCGGGT
TCCGTCATGCATAAATCAA->CCGTCATGCATAAATCAAA
TCCGTGCAAACAGGATCAC->CCGTGCAAACAGGATCACC
TCCTCCAACGAACCTGTGG->CCTCCAACGAACCTGTGGA
TCCTGAGTGTGGCACCCTT->CCTGAGTGTGGCACCCTTA
TCCTGCTAAGATGACGCCT->CCTGCTAAGATGACGCCTA
TCCTGCTTCAGGTACCAAT->CCTGCTTCAGGTACCAATT
TCCTGGCTTAGTAAAATCC->CCTGGCTTAGTAAAATCCC
TCCTTATCGCGGGTCACCA->CCTTATCGCGGGTCACCAG
TCCTTTTTAACTGTGGATG->CCTTTTTAACTGTGGATGA
TCGAATAAAAGCCTCGGCT->CGAATAAAAGCCTCGGCTA
TCGAGAGAATGCATTGATG->CGAGAGAATGCATTGATGC
TCGCACGCGGTACACACCT->CGCACGCGGTACACACCTG
TCGCAGTGAATTCAGAACG->CGCAGTGAATTCAGAACGC
TCGCATTGATTCTGCATTT->CGCATTGATTCTGCATTTA
TCGCCGACCTAGTACGGCT->CGCCGACCTAGTACGGCTA
TCGCCTAGCGGCCGGCGGA->CGCCTAGCGGCCGGCGGAT
TCGCCTGTGTATGGACCTA->CGCCTGTGTATGGACCTAA
TCGCGCGCTCCCGACGACG->CGCGCGCTCCCGACGACGC
TCGCGGGATTTCGCAGTGA->CGCGGGATTTCGCAGTGAA
TCGCGGGTCACCAGAAATT->CGCGGGTCACCAGAAATTC
TCGCGTCGTTAGCCTTCAG->CGCGTCGTTAGCCTTCAGC
TCGCGTTCCTGCTTCAGGT->CGCGTTCCTGCTTCAGGTA
TCGCTAGACTGGATTTGCA->CGCTAGACTGGATTTGCAC
TCGCTAGGCAGCAGGTGTA->CGCTAGGCAGCAGGTGTAC
TCGGAACGGTGTGGGACGT->CGGAACGGTGTGGGACGTT
TCGGAACTATAGCTTCTAA->CGGAACTATAGCTTCTAAA
TCGGACACTCGGCGGGAAC->CGGACACTCGGCGGGAACG
TCGGACCACAGTGACATGA->CGGACCACAGTGACATGAA
TCGGATTGGCGCGGACTAG->CGGATTGGCGCGGACTAGG
TCGGCAAGTTATCTTCATC->CGGCAAGTTATCTTCATCA
TCGGCGGGAACGCTATGAC->CGGCGGGAACGCTATGACT
TCGGCTAACTAGCTCCCCG->CGGCTAACTAGCTCCCCGC
TCGGGCCCTAAAAGGCCCC->CGGGCCCTAAAAGGCCCCA
TCGGTCGGCAAGTTATCTT->CGGTCGGCAAGTTATCTTC
TCGTAAAGGGAGAGGCTCG->CGTAAAGGGAGAGGCTCGG
TCGTAATCCGCGACAGATG->CGTAATCCGCGACAGATGA
TCGTACAGCTACACCTTCA->CGTACAGCTACACCTTCAG
TCGTCGCGTCGTTAGCCTT->CGTCGCGTCGTTAGCCTTC
TCGTCTGGCCCACGCGAGG->CGTCTGGCCCACGCGAGGA
TCGTGGGTGGTGGGCCGAT->CGTGGGTGGTGGGCCGATC
TCGTTAGCCTTCAGCCTGC->CGTTAGCCTTCAGCCTGCA
TCTAAAAGCTCTACTGGTA->CTAAAAGCTCTACTGGTAA
TCTAAAAGTCTAACAGACT->CTAAAAGTCTAACAGACTA
TCTAACAGACTAAGTTGGA->CTAACAGACTAAGTTGGAT
TCTACGCAGTCTACTAACA->CTACGCAGTCTACTAACAG
TCTACTAACAGATATTGAC->CTACTAACAGATATTGACC
TCTACTGGTAATTAGATAT->CTACTGGTAATTAGATATA
TCTAGGAGCTCCCTGTCCC->CTAGGAGCTCCCTGTCCCT
TCTATCCAGCGGGTGTGAA->CTATCCAGCGGGTGTGAAA
TCTATCCGATTCGGATTGG->CTATCCGATTCGGATTGGC
TCTATTACGGACGTTGGCA->CTATTACGGACGTTGGCAT
TCTCGCCTAGCGGCCGGCG->CTCGCCTAGCGGCCGGCGG
TCTCGCCTGTGTATGGACC->CTCGCCTGTGTATGGACCT
TCTCGCGGGATTTCGCAGT->CTCGCGGGATTTCGCAGTG
TCTCTGGGAATGATCAAGC->CTCTGGGAATGATCAAGCT
TCTGAAATTTGCCCGCTCG->CTGAAATTTGCCCGCTCGC
TCTGAATCCCAGCTCCCTG->CTGAATCCCAGCTCCCTGT
TCTGATCGGACACTCGGCG->CTGATCGGACACTCGGCGG
TCTGCATTTATGATAACGA->CTGCATTTATGATAACGAG
TCTGGCCCACGCGAGGACG->CTGGCCCACGCGAGGACGG
TCTGGGAAATATTCCTCCA->CTGGGAAATATTCCTCCAA
TCTGGGAATGATCAAGCTC->CTGGGAATGATCAAGCTCA
TCTGTAATAGTCGGTCGGC->CTGTAATAGTCGGTCGGCA
TCTGTATGTTCCGCGCCAC->CTGTATGTTCCGCGCCACC
TCTTACTACCTTTTCCTTT->CTTACTACCTTTTCCTTTT
TCTTAGCCGAGCTATTAGT->CTTAGCCGAGCTATTAGTC
TCTTCATCATGATCTTTGT->CTTCATCATGATCTTTGTC
TCTTCCTTATCGCGGGTCA->CTTCCTTATCGCGGGTCAC
TCTTCGCGCGCTCCCGACG->CTTCGCGCGCTCCCGACGA
TCTTGTCGCTAGACTGGAT->CTTGTCGCTAGACTGGATT
TCTTTACGGAGGGAACGCA->CTTTACGGAGGGAACGCAC
TCTTTGTCAGAAAGTCCGA->CTTTGTCAGAAAGTCCGAA
TCTTTGTCTCTGGGAATGA->CTTTGTCTCTGGGAATGAT
TGAAAGATCTACGCAGTCT->GAAAGATCTACGCAGTCTA
TGAAATTTGCCCGCTCGCT->GAAATTTGCCCGCTCGCTA
TGAACTAAAACGGTCTCGC->GAACTAAAACGGTCTCGCG
TGAAGATCCAAACACTTCG->GAAGATCCAAACACTTCGG
TGAATCCCAGCTCCCTGTC->GAATCCCAGCTCCCTGTCC
TGAATTACACAGATATGCT->GAATTACACAGATATGCTG
TGAATTCAGAACGCTCATT->GAATTCAGAACGCTCATTT
TGACAATTGGAGTGCGCTT->GACAATTGGAGTGCGCTTC
TGACATGAATTACACAGAT->GACATGAATTACACAGATA
TGACCGCGCCTGCACCAGA->GACCGCGCCTGCACCAGAT
TGACCGGACGACGAGGTAT->GACCGGACGACGAGGTATA
TGACGAATCCATGCTACCC->GACGAATCCATGCTACCCG
TGACGAGCACCTACTCTTT->GACGAGCACCTACTCTTTG
TGACGCCCCAGACGTAGGT->GACGCCCCAGACGTAGGTT
TGACGCCTAGAACTGCCGA->GACGCCTAGAACTGCCGAG
TGACGCTGCTCGAGAGAAT->GACGCTGCTCGAGAGAATG
TGACTGGAGGAGAGCATTG->GACTGGAGGAGAGCATTGT
TGACTTCATCTTAGCCGAG->GACTTCATCTTAGCCGAGC
TGAGCGATCTGTAATAGTC->GAGCGATCTGTAATAGTCG
TGAGGGGGCCCTGGGGTTG->GAGGGGGCCCTGGGGTTGC
TGAGTGTGGCACCCTTATA->GAGTGTGGCACCCTTATAA
TGATAACGAGAAAGTGACG->GATAACGAGAAAGTGACGC
TGATCAACCAACCATCTTA->GATCAACCAACCATCTTAC
TGATCAAGCTCACTTTAAG->GATCAAGCTCACTTTAAGT
TGATCGGACACTCGGCGGG->GATCGGACACTCGGCGGGA
TGATCTTTGTCAGAAAGTC->GATCTTTGTCAGAAAGTCC
TGATGCAGTGCGTCGTCTG->GATGCAGTGCGTCGTCTGG
TGATGTATGGTCAGAACAG->GATGTATGGTCAGAACAGG
TGATTACGAAACCAGAGAT->GATTACGAAACCAGAGATC
TGATTATCCCACGCATTTT->GATTATCCCACGCATTTTT
TGATTCTGCATTTATGATA->GATTCTGCATTTATGATAA
TGCAAACAGGATCACCACT->GCAAACAGGATCACCACTT
TGCAAATGGCTGATTACGA->GCAAATGGCTGATTACGAA
TGCACAAATCTTGTCGCTA->GCACAAATCTTGTCGCTAG
TGCACACCGCAGCTAGATG->GCACACCGCAGCTAGATGA
TGCACGAAAGGTGTTCCAA->GCACGAAAGGTGTTCCAAA
TGCAGGACCATGCAAATGG->GCAGGACCATGCAAATGGC
TGCAGTGCGTCGTCTGGCC->GCAGTGCGTCGTCTGGCCC
TGCATAAATCAAATGGACT->GCATAAATCAAATGGACTA
TGCATACCGGAAACTGCTA->GCATACCGGAAACTGCTAA
TGCATTGATGCAGTGCGTC->GCATTGATGCAGTGCGTCG
TGCATTTATGATAACGAGA->GCATTTATGATAACGAGAA
TGCCCGCTCGCTAGGCAGC->GCCCGCTCGCTAGGCAGCA
TGCCCTCCCCACCTTGCAC->GCCCTCCCCACCTTGCACG
TGCCGAGTTATATGTCCGT->GCCGAGTTATATGTCCGTG
TGCCGGCTTCTTCGCGCGC->GCCGGCTTCTTCGCGCGCT
TGCGCCATAGCAACAATGT->GCGCCATAGCAACAATGTG
TGCGCTTCTATTACGGACG->GCGCTTCTATTACGGACGT
TGCGGAAACCCCATTTAAC->GCGGAAACCCCATTTAACG
TGCGGGCTAGCCTCGCGTT->GCGGGCTAGCCTCGCGTTC
TGCGTACCCACAAAACCCG->GCGTACCCACAAAACCCGC
TGCGTCGTCTGGCCCACGC->GCGTCGTCTGGCCCACGCG
TGCTAAATGCAGGACCATG->GCTAAATGCAGGACCATGC
TGCTAAGATGACGCCTAGA->GCTAAGATGACGCCTAGAA
TGCTAATCGTACAGCTACA->GCTAATCGTACAGCTACAC
TGCTACCCGATTAACGCGC->GCTACCCGATTAACGCGCG
TGCTCGAGAGAATGCATTG->GCTCGAGAGAATGCATTGA
TGCTCTCGCCTGTGTATGG->GCTCTCGCCTGTGTATGGA
TGCTGACCGCGCCTGCACC->GCTGACCGCGCCTGCACCA
TGCTGCTCTCGCCTGTGTA->GCTGCTCTCGCCTGTGTAT
TGCTTCAGGTACCAATTTT->GCTTCAGGTACCAATTTTT
TGGACCTAAGCTCCCTGTC->GGACCTAAGCTCCCTGTCC
TGGACTATAAGAATATTCC->GGACTATAAGAATATTCCT
TGGAGAGAGTATACTGGTG->GGAGAGAGTATACTGGTGA
TGGAGCTAAGCTTGTGTTA->GGAGCTAAGCTTGTGTTAG
TGGAGGAGAGCATTGTACA->GGAGGAGAGCATTGTACAG
TGGAGGCTAGGCCTGGAGC->GGAGGCTAGGCCTGGAGCT
TGGAGTGCGCTTCTATTAC->GGAGTGCGCTTCTATTACG
TGGATGACTTCATCTTAGC->GGATGACTTCATCTTAGCC
TGGATTGGGGGGAACAGGA->GGATTGGGGGGAACAGGAA
TGGATTTGCACACCGCAGC->GGATTTGCACACCGCAGCT
TGGCACCCTTATAAGACAA->GGCACCCTTATAAGACAAC
TGGCATCGCACGCGGTACA->GGCATCGCACGCGGTACAC
TGGCATTAGGTGCTAATCG->GGCATTAGGTGCTAATCGT
TGGCCCACGCGAGGACGGG->GGCCCACGCGAGGACGGGT
TGGCCTAAGGCGGTTTGAA->GGCCTAAGGCGGTTTGAAG
TGGCGCGGACTAGGCGCGT->GGCGCGGACTAGGCGCGTT
TGGCTGATTACGAAACCAG->GGCTGATTACGAAACCAGA
TGGCTTAGTAAAATCCCCT->GGCTTAGTAAAATCCCCTA
TGGGAAATATTCCTCCAAC->GGGAAATATTCCTCCAACG
TGGGAATGATCAAGCTCAC->GGGAATGATCAAGCTCACT
TGGGACGTTTTGTGAGGGG->GGGACGTTTTGTGAGGGGG
TGGGATGTGTAGATATTGT->GGGATGTGTAGATATTGTC
TGGGCCGATCTGAATCCCA->GGGCCGATCTGAATCCCAG
TGGGGGGAACAGGAAATTC->GGGGGGAACAGGAAATTCT
TGGGGTTGCACAAATCTTG->GGGGTTGCACAAATCTTGT
TGGGTGGTGGGCCGATCTG->GGGTGGTGGGCCGATCTGA
TGGTAATTAGATATACCTA->GGTAATTAGATATACCTAC
TGGTATCGTAATCCGCGAC->GGTATCGTAATCCGCGACA
TGGTCAGAACAGGAAGGGG->GGTCAGAACAGGAAGGGGA
TGGTGATCAACCAACCATC->GGTGATCAACCAACCATCT
TGGTGGCATCGCACGCGGT->GGTGGCATCGCACGCGGTA
TGGTGGGCCGATCTGAATC->GGTGGGCCGATCTGAATCC
TGTAATAGTCGGTCGGCAA->GTAATAGTCGGTCGGCAAG
TGTACAGTTATGGCCTAAG->GTACAGTTATGGCCTAAGG
TGTACTAGTTCGAATAAAA->GTACTAGTTCGAATAAAAG
TGTAGATATTGTCAAAGCT->GTAGATATTGTCAAAGCTG
TGTATGGACCTAAGCTCCC->GTATGGACCTAAGCTCCCT
TGTATGGTCAGAACAGGAA->GTATGGTCAGAACAGGAAG
TGTATGTTCCGCGCCACCC->GTATGTTCCGCGCCACCCC
TGTCAAAGCTGAGCGATCT->GTCAAAGCTGAGCGATCTG
TGTCAGAAAGTCCGAATAG->GTCAGAAAGTCCGAATAGG
TGTCCCTAGGCACATGCGT->GTCCCTAGGCACATGCGTA
TGTCCCTAGGCCCGACTCA->GTCCCTAGGCCCGACTCAA
TGTCCCTAGGCGCAAAATT->GTCCCTAGGCGCAAAATTA
TGTCCCTAGGCTACAGAAC->GTCCCTAGGCTACAGAACG
TGTCCGTGCAAACAGGATC->GTCCGTGCAAACAGGATCA
TGTCGCTAGACTGGATTTG->GTCGCTAGACTGGATTTGC
TGTCGGAACTATAGCTTCT->GTCGGAACTATAGCTTCTA
TGTCTCGCCTAGCGGCCGG->GTCTCGCCTAGCGGCCGGC
TGTCTCTGGGAATGATCAA->GTCTCTGGGAATGATCAAG
TGTGAAAGATCTACGCAGT->GTGAAAGATCTACGCAGTC
TGTGAGGGGGCCCTGGGGT->GTGAGGGGGCCCTGGGGTT
TGTGCCCTCCCCACCTTGC->GTGCCCTCCCCACCTTGCA
TGTGGAGAGAGTATACTGG->GTGGAGAGAGTATACTGGT
TGTGGATGACTTCATCTTA->GTGGATGACTTCATCTTAG
TGTGGCACCCTTATAAGAC->GTGGCACCCTTATAAGACA
TGTGGGACGTTTTGTGAGG->GTGGGACGTTTTGTGAGGG
TGTGTAGATATTGTCAAAG->GTGTAGATATTGTCAAAGC
TGTGTATGGACCTAAGCTC->GTGTATGGACCTAAGCTCC
TGTGTTAGCACGCTTTGCG->GTGTTAGCACGCTTTGCGG
TGTTACTTAATCCGCCCAG->GTTACTTAATCCGCCCAGT
TGTTAGCACGCTTTGCGGG->GTTAGCACGCTTTGCGGGC
TGTTCCAAATTCCATGGGA->GTTCCAAATTCCATGGGAT
TGTTCCGCGCCACCCCTTC->GTTCCGCGCCACCCCTTCA
TTAACGCGCGAACAATGAC->TAACGCGCGAACAATGACG
TTAACGGCTGTCTCGCCTA->TAACGGCTGTCTCGCCTAG
TTAACTGTGGATGACTTCA->TAACTGTGGATGACTTCAT
TTAAGTCAGATGCCGGCTT->TAAGTCAGATGCCGGCTTC
TTAATCCGCCCAGTATAAT->TAATCCGCCCAGTATAATC
TTACACAGATATGCTGCTC->TACACAGATATGCTGCTCT
TTACGAAACCAGAGATCAC->TACGAAACCAGAGATCACT
TTACGAACGTACGACCGCA->TACGAACGTACGACCGCAG
TTACGGACGTTGGCATTAG->TACGGACGTTGGCATTAGG
TTACGGAGGGAACGCACTC->TACGGAGGGAACGCACTCT
TTACGTCGCATTGATTCTG->TACGTCGCATTGATTCTGC
TTACTACCTTTTCCTTTTT->TACTACCTTTTCCTTTTTA
TTACTTAATCCGCCCAGTA->TACTTAATCCGCCCAGTAT
TTAGATATACCTACGGTAC->TAGATATACCTACGGTACT
TTAGCACGCTTTGCGGGCT->TAGCACGCTTTGCGGGCTA
TTAGCCGAGCTATTAGTCT->TAGCCGAGCTATTAGTCTT
TTAGCCTTCAGCCTGCATA->TAGCCTTCAGCCTGCATAC
TTAGGGGCGTCGTCGCGTC->TAGGGGCGTCGTCGCGTCG
TTAGGTGCTAATCGTACAG->TAGGTGCTAATCGTACAGC
TTAGGTTCCTGGCTTAGTA->TAGGTTCCTGGCTTAGTAA
TTAGTAAAATCCCCTAGGC->TAGTAAAATCCCCTAGGCC
TTAGTCTTCCTTATCGCGG->TAGTCTTCCTTATCGCGGG
TTAGTGCTGACCGCGCCTG->TAGTGCTGACCGCGCCTGC
TTATAAGACAACCTATGTT->TATAAGACAACCTATGTTA
TTATATGTCCGTGCAAACA->TATATGTCCGTGCAAACAG
TTATCCCACGCATTTTTTG->TATCCCACGCATTTTTTGA
TTATCGCGGGTCACCAGAA->TATCGCGGGTCACCAGAAA
TTATCTAAAAGCTCTACTG->TATCTAAAAGCTCTACTGG
TTATCTTCATCATGATCTT->TATCTTCATCATGATCTTT
TTATGATAACGAGAAAGTG->TATGATAACGAGAAAGTGA
TTATGGCCTAAGGCGGTTT->TATGGCCTAAGGCGGTTTG
TTATTCACAAAACCCGCGT->TATTCACAAAACCCGCGTC
TTATTCTGAAATTTGCCCG->TATTCTGAAATTTGCCCGC
TTCAAACCCATTACGAACG->TCAAACCCATTACGAACGT
TTCACAAAACCCGCGTCCG->TCACAAAACCCGCGTCCGG
TTCACTCGTGGGTGGTGGG->TCACTCGTGGGTGGTGGGC
TTCAGAACGCTCATTTTAT->TCAGAACGCTCATTTTATC
TTCAGCCTGCATACCGGAA->TCAGCCTGCATACCGGAAA
TTCAGGTACCAATTTTTAC->TCAGGTACCAATTTTTACG
TTCAGGTCACTGCGCCATA->TCAGGTCACTGCGCCATAG
TTCATCATGATCTTTGTCA->TCATCATGATCTTTGTCAG
TTCATCTTAGCCGAGCTAT->TCATCTTAGCCGAGCTATT
TTCCAAATTCCATGGGATG->TCCAAATTCCATGGGATGT
TTCCAGTAATAGTGCGGAA->TCCAGTAATAGTGCGGAAA
TTCCATGAACTAAAACGGT->TCCATGAACTAAAACGGTC
TTCCATGGGATGTGTAGAT->TCCATGGGATGTGTAGATA
TTCCGCGCCACCCCTTCAA->TCCGCGCCACCCCTTCAAA
TTCCTCCAACGAACCTGTG->TCCTCCAACGAACCTGTGG
TTCCTGAGTGTGGCACCCT->TCCTGAGTGTGGCACCCTT
TTCCTGCTTCAGGTACCAA->TCCTGCTTCAGGTACCAAT
TTCCTGGCTTAGTAAAATC->TCCTGGCTTAGTAAAATCC
TTCCTTATCGCGGGTCACC->TCCTTATCGCGGGTCACCA
TTCCTTTTTAACTGTGGAT->TCCTTTTTAACTGTGGATG
TTCGAATAAAAGCCTCGGC->TCGAATAAAAGCCTCGGCT
TTCGCAGTGAATTCAGAAC->TCGCAGTGAATTCAGAACG
TTCGCCGACCTAGTACGGC->TCGCCGACCTAGTACGGCT
TTCGCGCGCTCCCGACGAC->TCGCGCGCTCCCGACGACG
TTCGGAACGGTGTGGGACG->TCGGAACGGTGTGGGACGT
TTCGGATTGGCGCGGACTA->TCGGATTGGCGCGGACTAG
TTCTAAAAGTCTAACAGAC->TCTAAAAGTCTAACAGACT
TTCTAGGAGCTCCCTGTCC->TCTAGGAGCTCCCTGTCCC
TTCTATCCGATTCGGATTG->TCTATCCGATTCGGATTGG
TTCTATTACGGACGTTGGC->TCTATTACGGACGTTGGCA
TTCTGAAATTTGCCCGCTC->TCTGAAATTTGCCCGCTCG
TTCTGCATTTATGATAACG->TCTGCATTTATGATAACGA
TTCTGTATGTTCCGCGCCA->TCTGTATGTTCCGCGCCAC
TTCTTCGCGCGCTCCCGAC->TCTTCGCGCGCTCCCGACG
TTGAAGATCCAAACACTTC->TGAAGATCCAAACACTTCG
TTGACCGGACGACGAGGTA->TGACCGGACGACGAGGTAT
TTGACGAATCCATGCTACC->TGACGAATCCATGCTACCC
TTGATGCAGTGCGTCGTCT->TGATGCAGTGCGTCGTCTG
TTGATGTATGGTCAGAACA->TGATGTATGGTCAGAACAG
TTGATTCTGCATTTATGAT->TGATTCTGCATTTATGATA
TTGCACAAATCTTGTCGCT->TGCACAAATCTTGTCGCTA
TTGCACACCGCAGCTAGAT->TGCACACCGCAGCTAGATG
TTGCACGAAAGGTGTTCCA->TGCACGAAAGGTGTTCCAA
TTGCCCGCTCGCTAGGCAG->TGCCCGCTCGCTAGGCAGC
TTGCGGGCTAGCCTCGCGT->TGCGGGCTAGCCTCGCGTT
TTGGAGTGCGCTTCTATTA->TGGAGTGCGCTTCTATTAC
TTGGATTGGGGGGAACAGG->TGGATTGGGGGGAACAGGA
TTGGCATTAGGTGCTAATC->TGGCATTAGGTGCTAATCG
TTGGCGCGGACTAGGCGCG->TGGCGCGGACTAGGCGCGT
TTGGGGGGAACAGGAAATT->TGGGGGGAACAGGAAATTC
TTGGTGGCATCGCACGCGG->TGGTGGCATCGCACGCGGT
TTGTACAGTTATGGCCTAA->TGTACAGTTATGGCCTAAG
TTGTCAAAGCTGAGCGATC->TGTCAAAGCTGAGCGATCT
TTGTCAGAAAGTCCGAATA->TGTCAGAAAGTCCGAATAG
TTGTCGCTAGACTGGATTT->TGTCGCTAGACTGGATTTG
TTGTCGGAACTATAGCTTC->TGTCGGAACTATAGCTTCT
TTGTCTCTGGGAATGATCA->TGTCTCTGGGAATGATCAA
TTGTGAGGGGGCCCTGGGG->TGTGAGGGGGCCCTGGGGT
TTGTGTTAGCACGCTTTGC->TGTGTTAGCACGCTTTGCG
TTTAACGGCTGTCTCGCCT->TTAACGGCTGTCTCGCCTA
TTTAACTGTGGATGACTTC->TTAACTGTGGATGACTTCA
TTTAAGTCAGATGCCGGCT->TTAAGTCAGATGCCGGCTT
TTTACGGAGGGAACGCACT->TTACGGAGGGAACGCACTC
TTTACGTCGCATTGATTCT->TTACGTCGCATTGATTCTG
TTTAGGTTCCTGGCTTAGT->TTAGGTTCCTGGCTTAGTA
TTTATCTAAAAGCTCTACT->TTATCTAAAAGCTCTACTG
TTTATGATAACGAGAAAGT->TTATGATAACGAGAAAGTG
TTTCCATGAACTAAAACGG->TTCCATGAACTAAAACGGT
TTTCCTTTTTAACTGTGGA->TTCCTTTTTAACTGTGGAT
TTTCGCAGTGAATTCAGAA->TTCGCAGTGAATTCAGAAC
TTTGAAGATCCAAACACTT->TTGAAGATCCAAACACTTC
TTTGACGAATCCATGCTAC->TTGACGAATCCATGCTACC
TTTGCACACCGCAGCTAGA->TTGCACACCGCAGCTAGAT
TTTGCCCGCTCGCTAGGCA->TTGCCCGCTCGCTAGGCAG
TTTGCGGGCTAGCCTCGCG->TTGCGGGCTAGCCTCGCGT
TTTGTCAGAAAGTCCGAAT->TTGTCAGAAAGTCCGAATA
TTTGTCTCTGGGAATGATC->TTGTCTCTGGGAATGATCA
TTTGTGAGGGGGCCCTGGG->TTGTGAGGGGGCCCTGGGG
TTTTAACTGTGGATGACTT->TTTAACTGTGGATGACTTC
TTTTACGTCGCATTGATTC->TTTACGTCGCATTGATTCT
TTTTAGGTTCCTGGCTTAG->TTTAGGTTCCTGGCTTAGT
TTTTATCTAAAAGCTCTAC->TTTATCTAAAAGCTCTACT
TTTTCCTTTTTAACTGTGG->TTTCCTTTTTAACTGTGGA
TTTTGACGAATCCATGCTA->TTTGACGAATCCATGCTAC
TTTTGTGAGGGGGCCCTGG->TTTGTGAGGGGGCCCTGGG
TTTTTAACTGTGGATGACT->TTTTAACTGTGGATGACTT
TTTTTACGTCGCATTGATT->TTTTACGTCGCATTGATTC
TTTTTAGGTTCCTGGCTTA->TTTTAGGTTCCTGGCTTAG
TTTTTGACGAATCCATGCT->TTTTGACGAATCCATGCTA
TTTTTTAGGTTCCTGGCTT->TTTTTAGGTTCCTGGCTTA
TTTTTTGACGAATCCATGC->TTTTTGACGAATCCATGCT
